"aj" = (/obj/effect/mapping_helpers/smart_pipe/simple/scrubbers/hidden/layer4,/obj/effect/mapping_helpers/smart_pipe/manifold/supply/hidden/layer2,/turf/closed/wall/r_wall,/area/ruin/space/broadcast_station)
"aO" = (/obj/machinery/atmospherics/components/unary/vent_scrubber/on/layer4{dir = 8},/turf/open/floor/iron/cafeteria,/area/ruin/space/broadcast_station)
"bf" = (/obj/effect/mapping_helpers/smart_pipe/simple/scrubbers/hidden/layer4,/obj/effect/mapping_helpers/smart_pipe/simple/supply/hidden/layer2,/obj/structure/closet/crate/hydroponics,/obj/item/reagent_containers/glass/bucket/wooden{layer = 3.5},/obj/item/cultivator,/obj/item/shovel/spade,/obj/item/secateurs,/obj/item/plant_analyzer,/obj/item/reagent_containers/spray/plantbgone,/obj/item/storage/bag/plants,/obj/item/reagent_containers/glass/bucket/wooden{layer = 3.5},/obj/item/reagent_containers/glass/bucket/wooden{layer = 3.5},/turf/open/floor/iron,/area/ruin/space/broadcast_station)
"cG" = (/obj/effect/mapping_helpers/smart_pipe/simple/scrubbers/hidden/layer4,/obj/structure/table,/obj/machinery/reagentgrinder{pixel_x = -5; pixel_y = 9},/obj/item/kitchen/knife{pixel_x = 10; pixel_y = 3},/turf/open/floor/iron/cafeteria,/area/ruin/space/broadcast_station)
"cI" = (/obj/machinery/atmospherics/components/unary/outlet_injector/on/layer4{dir = 1},/turf/open/floor/plating/lowpressure,/area/ruin/space/broadcast_station/waste)
"cR" = (/obj/machinery/light/directional/north,/turf/open/floor/engine,/area/ruin/space/broadcast_station)
"ds" = (/obj/machinery/telecomms/broadcaster/preset_broadcast,/turf/open/floor/engine,/area/ruin/space/broadcast_station)
"eJ" = (/turf/open/floor/iron,/area/ruin/space/broadcast_station)
"eR" = (/obj/structure/sign/poster/official/pda_ad,/turf/closed/wall/r_wall,/area/ruin/space/broadcast_station)
"fF" = (/obj/structure/table,/obj/machinery/processor{pixel_y = 6},/turf/open/floor/iron/cafeteria,/area/ruin/space/broadcast_station)
"fS" = (/obj/effect/mapping_helpers/smart_pipe/simple/supply/hidden/layer2{dir = 6},/turf/closed/wall/r_wall,/area/ruin/space/broadcast_station)
"fU" = (/obj/structure/sign/poster/official/foam_force_ad,/turf/closed/wall/r_wall,/area/ruin/space/broadcast_station)
"gH" = (/obj/machinery/atmospherics/components/unary/vent_pump/high_volume/siphon/on/layer2,/turf/open/floor/engine/n2,/area/ruin/space/broadcast_station)
"hz" = (/obj/structure/sign/poster/contraband/starkist,/turf/closed/wall/r_wall,/area/ruin/space/broadcast_station)
"hV" = (/obj/effect/mapping_helpers/smart_pipe/manifold/supply/hidden/layer2{dir = 8},/turf/open/floor/iron,/area/ruin/space/broadcast_station)
"hZ" = (/obj/machinery/light/small/directional/west,/turf/open/floor/iron,/area/ruin/space/broadcast_station)
"iC" = (/obj/machinery/atmospherics/components/unary/vent_pump/on/layer2{dir = 1},/turf/open/floor/iron,/area/ruin/space/broadcast_station)
"iX" = (/obj/machinery/atmospherics/components/unary/vent_scrubber/on/layer4,/obj/structure/cable,/turf/open/floor/engine,/area/ruin/space/broadcast_station)
"jn" = (/obj/docking_port/stationary/large{dir = 2; name = "Broadcast Station Dock"; roundstart_template = /datum/map_template/shuttle/common/pigeon},/turf/open/space/basic,/area/space)
"jB" = (/obj/structure/sign/poster/contraband/lusty_xenomorph,/turf/closed/wall/r_wall,/area/ruin/space/broadcast_station)
"jL" = (/obj/machinery/portable_atmospherics/canister/oxygen,/obj/machinery/atmospherics/miner/oxygen,/obj/machinery/light/directional/north,/turf/open/floor/engine/o2,/area/ruin/space/broadcast_station)
"jZ" = (/obj/machinery/door/airlock/public/glass,/obj/effect/mapping_helpers/smart_pipe/simple/supply/hidden/layer2{dir = 10},/turf/open/floor/iron,/area/ruin/space/broadcast_station)
"kq" = (/obj/effect/mapping_helpers/smart_pipe/manifold/supply/hidden/layer2{dir = 1},/turf/closed/wall/r_wall,/area/ruin/space/broadcast_station)
"ll" = (/obj/machinery/atmospherics/components/unary/vent_pump/high_volume/siphon/on/layer2{dir = 8},/turf/open/floor/engine/o2,/area/ruin/space/broadcast_station)
"lt" = (/turf/closed/wall/r_wall,/area/ruin/space/broadcast_station)
"mv" = (/obj/machinery/telecomms/processor/preset_broadcast,/turf/open/floor/engine,/area/ruin/space/broadcast_station)
"mz" = (/obj/structure/closet/crate/internals,/obj/item/tank/internals/emergency_oxygen/double{layer = 2.9},/obj/item/clothing/head/helmet/space/eva{layer = 3.1},/obj/item/tank/internals/emergency_oxygen/double{layer = 2.9},/obj/item/clothing/suit/space/eva,/obj/item/clothing/mask/breath{layer = 3.5},/turf/open/floor/carpet,/area/ruin/space/broadcast_station)
"mG" = (/obj/machinery/light/directional/east,/obj/structure/water_source{dir = 8; pixel_x = 13},/turf/open/floor/iron,/area/ruin/space/broadcast_station)
"nR" = (/obj/structure/table/reinforced,/obj/item/radio/broadcast{pixel_x = 4; pixel_y = 9},/turf/open/floor/carpet/neon/simple/white/nodots,/area/ruin/space/broadcast_station)
"oe" = (/obj/machinery/atmospherics/components/unary/vent_pump/on/layer2{dir = 8},/turf/open/floor/iron,/area/ruin/space/broadcast_station)
"oI" = (/obj/structure/cable,/turf/closed/wall/r_wall,/area/ruin/space/broadcast_station)
"oX" = (/obj/effect/mapping_helpers/smart_pipe/simple/scrubbers/hidden/layer4,/turf/closed/wall/r_wall,/area/ruin/space/broadcast_station)
"qj" = (/turf/open/space/basic,/area/space)
"qw" = (/obj/effect/mapping_helpers/smart_pipe/simple/scrubbers/hidden/layer4{dir = 4},/turf/open/floor/carpet,/area/ruin/space/broadcast_station)
"qL" = (/obj/effect/mob_spawn/human/broadcast,/turf/open/floor/carpet,/area/ruin/space/broadcast_station)
"qS" = (/obj/machinery/vending/hydroseeds{onstation = 0},/turf/open/floor/iron,/area/ruin/space/broadcast_station)
"rc" = (/obj/structure/table,/turf/open/floor/iron/cafeteria,/area/ruin/space/broadcast_station)
"rg" = (/obj/machinery/seed_extractor,/turf/open/floor/iron,/area/ruin/space/broadcast_station)
"sG" = (/obj/machinery/smartfridge,/turf/closed/wall/r_wall,/area/ruin/space/broadcast_station)
"sR" = (/obj/machinery/telecomms/receiver/preset_broadcast,/turf/open/floor/engine,/area/ruin/space/broadcast_station)
"tz" = (/obj/structure/sign/poster/contraband/pwr_game,/turf/closed/wall/r_wall,/area/ruin/space/broadcast_station)
"ud" = (/obj/machinery/light/directional/north,/turf/open/floor/iron,/area/ruin/space/broadcast_station)
"uj" = (/obj/machinery/light/directional/west,/obj/effect/mapping_helpers/smart_pipe/manifold4w/scrubbers/hidden/layer4,/turf/open/floor/iron/cafeteria,/area/ruin/space/broadcast_station)
"ux" = (/obj/machinery/atmospherics/components/unary/vent_scrubber/on/layer4{dir = 8},/turf/open/floor/iron,/area/ruin/space/broadcast_station)
"uX" = (/obj/effect/mapping_helpers/smart_pipe/simple/supply/hidden/layer2,/turf/open/floor/iron,/area/ruin/space/broadcast_station)
"uY" = (/obj/effect/mapping_helpers/smart_pipe/simple/scrubbers/hidden/layer4,/turf/open/floor/iron/cafeteria,/area/ruin/space/broadcast_station)
"vc" = (/obj/machinery/door/airlock/public/glass,/obj/effect/mapping_helpers/smart_pipe/simple/scrubbers/hidden/layer4,/obj/effect/mapping_helpers/smart_pipe/simple/supply/hidden/layer2{dir = 4},/turf/open/floor/iron,/area/ruin/space/broadcast_station)
"vi" = (/obj/machinery/atmospherics/components/unary/vent_pump/on/layer2{dir = 1},/obj/effect/mapping_helpers/smart_pipe/simple/scrubbers/hidden/layer4{dir = 4},/turf/open/floor/iron/cafeteria,/area/ruin/space/broadcast_station)
"vw" = (/obj/machinery/light/directional/east,/turf/open/floor/iron/cafeteria,/area/ruin/space/broadcast_station)
"wa" = (/obj/machinery/light/directional/west,/obj/structure/table/reinforced,/obj/item/flashlight/lamp{pixel_x = -4; pixel_y = 11},/obj/item/pizzabox/margherita,/obj/item/pizzabox/meat{pixel_y = 4},/turf/open/floor/carpet/neon/simple/white/nodots,/area/ruin/space/broadcast_station)
"wm" = (/obj/machinery/griddle,/turf/open/floor/iron/cafeteria,/area/ruin/space/broadcast_station)
"wP" = (/obj/effect/mapping_helpers/smart_pipe/simple/supply/hidden/layer2,/obj/effect/mapping_helpers/smart_pipe/simple/scrubbers/hidden/layer4{dir = 6},/obj/structure/reagent_dispensers/watertank/high,/turf/open/floor/iron,/area/ruin/space/broadcast_station)
"xP" = (/obj/effect/mapping_helpers/smart_pipe/simple/supply/hidden/layer2{dir = 4},/turf/closed/wall/r_wall,/area/ruin/space/broadcast_station)
"yF" = (/obj/structure/sign/poster/official/enlist,/turf/closed/wall/r_wall,/area/ruin/space/broadcast_station)
"Ah" = (/turf/open/floor/carpet,/area/ruin/space/broadcast_station)
"AS" = (/obj/structure/sign/poster/contraband/have_a_puff,/turf/closed/wall/r_wall,/area/ruin/space/broadcast_station)
"BG" = (/obj/effect/mapping_helpers/smart_pipe/simple/supply/hidden/layer2{dir = 5},/turf/closed/wall/r_wall,/area/ruin/space/broadcast_station)
"BZ" = (/obj/structure/sign/poster/official/cohiba_robusto_ad,/turf/closed/wall/r_wall,/area/ruin/space/broadcast_station)
"Dg" = (/obj/machinery/door/airlock/public/glass{dir = 4},/turf/open/floor/iron,/area/ruin/space/broadcast_station)
"Dz" = (/obj/effect/mapping_helpers/smart_pipe/simple/scrubbers/hidden/layer4{dir = 4},/turf/closed/wall/r_wall,/area/ruin/space/broadcast_station)
"DY" = (/obj/structure/chair/office{dir = 8},/turf/open/floor/carpet/neon/simple/white/nodots,/area/ruin/space/broadcast_station)
"DZ" = (/obj/machinery/atmospherics/components/unary/vent_scrubber/on/layer4{dir = 4},/turf/open/floor/carpet,/area/ruin/space/broadcast_station)
"Ei" = (/obj/machinery/atmospherics/components/unary/vent_pump/on/layer2{dir = 8},/turf/open/floor/engine,/area/ruin/space/broadcast_station)
"Em" = (/obj/machinery/vending/clothing{default_price = 0},/turf/open/floor/carpet,/area/ruin/space/broadcast_station)
"Fl" = (/obj/machinery/hydroponics/constructable,/obj/effect/mapping_helpers/smart_pipe/simple/supply/hidden/layer2{dir = 6},/turf/open/floor/iron,/area/ruin/space/broadcast_station)
"GW" = (/obj/machinery/door/airlock/external,/turf/open/floor/iron,/area/ruin/space/broadcast_station)
"If" = (/obj/machinery/vending/hydronutrients{onstation = 0},/turf/open/floor/iron,/area/ruin/space/broadcast_station)
"Il" = (/turf/open/floor/iron/cafeteria,/area/ruin/space/broadcast_station)
"Io" = (/obj/machinery/power/smes/magical{input_level = 200000; output_level = 200000},/obj/structure/cable,/turf/open/floor/engine,/area/ruin/space/broadcast_station)
"ID" = (/obj/machinery/hydroponics/constructable,/turf/open/floor/iron,/area/ruin/space/broadcast_station)
"KW" = (/obj/machinery/door/airlock/external,/obj/structure/fans/tiny,/turf/open/floor/iron,/area/ruin/space/broadcast_station)
"KZ" = (/obj/machinery/portable_atmospherics/canister/nitrogen,/obj/machinery/atmospherics/miner/nitrogen,/obj/machinery/light/directional/north,/turf/open/floor/engine/n2,/area/ruin/space/broadcast_station)
"LB" = (/obj/machinery/telecomms/relay/preset/broadcast,/obj/structure/cable,/turf/open/floor/engine,/area/ruin/space/broadcast_station)
"ML" = (/obj/machinery/power/apc/auto_name/north,/obj/machinery/power/terminal{dir = 1},/obj/structure/cable,/obj/effect/mapping_helpers/smart_pipe/simple/supply/hidden/layer2,/turf/open/floor/iron,/area/ruin/space/broadcast_station)
"Nz" = (/turf/open/floor/carpet/neon/simple/white/nodots,/area/ruin/space/broadcast_station)
"NW" = (/obj/machinery/light/directional/south,/turf/open/floor/carpet,/area/ruin/space/broadcast_station)
"Ok" = (/obj/machinery/atmospherics/components/trinary/mixer/airmix/flipped{dir = 8; layer = 2; piping_layer = 2; target_pressure = 250},/turf/closed/wall/r_wall,/area/ruin/space/broadcast_station)
"Om" = (/obj/effect/mapping_helpers/smart_pipe/simple/scrubbers/hidden/layer4,/turf/open/floor/carpet,/area/ruin/space/broadcast_station)
"QB" = (/obj/structure/sign/poster/contraband/donut_corp,/turf/closed/wall/r_wall,/area/ruin/space/broadcast_station)
"QH" = (/obj/structure/table,/obj/machinery/microwave{pixel_x = -1; pixel_y = 8},/turf/open/floor/iron/cafeteria,/area/ruin/space/broadcast_station)
"QW" = (/obj/structure/table,/obj/item/reagent_containers/food/condiment/enzyme{layer = 5},/obj/item/reagent_containers/glass/beaker{pixel_x = 5},/turf/open/floor/iron/cafeteria,/area/ruin/space/broadcast_station)
"Rk" = (/obj/machinery/telecomms/bus/preset_broadcast,/obj/effect/mapping_helpers/smart_pipe/simple/supply/hidden/layer2{dir = 4},/turf/open/floor/engine,/area/ruin/space/broadcast_station)
"Rn" = (/turf/closed/indestructible/rock,/area/space)
"Sp" = (/obj/effect/mapping_helpers/smart_pipe/manifold/scrubbers/hidden/layer4,/turf/open/floor/carpet,/area/ruin/space/broadcast_station)
"Vj" = (/obj/structure/sign/poster/contraband/random,/turf/closed/wall/r_wall,/area/ruin/space/broadcast_station)
"Wu" = (/obj/machinery/deepfryer,/turf/open/floor/iron/cafeteria,/area/ruin/space/broadcast_station)
"Xe" = (/obj/effect/mapping_helpers/smart_pipe/simple/supply/hidden/layer2,/turf/open/floor/iron/cafeteria,/area/ruin/space/broadcast_station)
"Xp" = (/obj/machinery/biogenerator,/turf/open/floor/iron,/area/ruin/space/broadcast_station)
"XL" = (/obj/machinery/airalarm/directional/north,/turf/open/floor/iron,/area/ruin/space/broadcast_station)
"XU" = (/obj/structure/closet/crate/engineering,/obj/item/storage/toolbox/mechanical,/obj/item/stack/sheet/iron/fifty{layer = 2.9},/obj/item/storage/toolbox/electrical{layer = 2.99},/obj/item/multitool{layer = 2.95},/obj/item/stack/sheet/glass/fifty{layer = 2.9},/obj/item/clothing/gloves/color/yellow{layer = 2.95},/turf/open/floor/iron,/area/ruin/space/broadcast_station)
"Yb" = (/obj/machinery/light/directional/east,/obj/effect/mapping_helpers/smart_pipe/simple/scrubbers/hidden/layer4{dir = 4},/turf/open/floor/carpet,/area/ruin/space/broadcast_station)
"Yy" = (/obj/effect/mapping_helpers/smart_pipe/simple/supply/hidden/layer2{dir = 4},/obj/machinery/power/terminal{dir = 1},/obj/structure/cable,/turf/closed/wall/r_wall,/area/ruin/space/broadcast_station)

(1,1,1) = {"
qjqjqjqjqjqjqjqjqjqjqjqjqjqjqjqjqjqjqjqjqjqjqjqjqjqjqjqjqjqjqjqjqjqjqjqjqjqjqjqjqjqjqjqjqjqjqjqjqjqj
qjqjqjqjqjqjqjqjqjqjqjqjqjqjqjqjqjqjqjqjqjqjqjqjqjqjqjqjqjqjqjqjqjqjqjqjqjqjqjqjqjqjqjqjqjqjqjqjqjqj
qjqjqjqjqjqjqjqjqjqjqjqjqjqjqjqjqjqjqjqjqjqjqjqjqjqjqjqjqjqjqjqjqjqjqjqjqjqjqjqjqjqjqjqjqjqjqjqjqjqj
qjqjqjqjqjqjqjqjqjqjqjqjqjqjqjqjqjqjqjqjqjqjqjqjqjqjqjqjqjqjqjqjqjqjqjqjqjqjqjqjqjqjqjqjqjqjqjqjqjqj
qjqjqjqjqjqjqjqjqjqjqjqjqjqjqjqjqjqjqjqjqjqjqjqjqjqjqjqjqjqjqjqjqjqjqjqjqjqjqjqjqjqjqjqjqjqjqjqjqjqj
qjqjqjqjqjqjqjqjqjqjqjqjqjqjqjqjqjqjqjqjqjqjqjqjqjqjqjqjqjqjqjqjqjqjqjqjqjqjqjqjqjqjqjqjqjqjqjqjqjqj
qjqjqjqjqjqjqjqjqjqjqjqjqjqjqjqjqjqjqjqjqjqjqjqjqjqjqjqjqjqjqjqjqjqjqjqjqjqjqjqjqjqjqjqjqjqjqjqjqjqj
qjqjqjqjqjqjqjqjqjqjqjqjqjqjqjqjqjqjqjqjqjqjqjqjqjqjqjqjqjqjqjqjqjqjqjqjqjqjqjqjqjqjqjqjqjqjqjqjqjqj
qjqjqjqjqjqjqjqjqjqjqjqjqjqjqjqjqjqjqjqjqjqjqjqjqjqjqjqjqjqjqjqjqjqjqjqjqjqjqjqjqjqjqjqjqjqjqjqjqjqj
qjqjqjqjqjqjqjqjqjqjqjqjqjqjqjqjqjqjqjqjqjqjqjqjRnRnRnqjqjqjqjqjqjqjqjqjqjqjqjqjqjqjqjqjqjqjqjqjqjqj
qjqjqjqjqjqjqjqjqjqjqjqjqjqjqjqjqjqjqjqjqjRnRnRnRnRnRnRnRnRnRnqjqjqjqjqjqjqjqjqjqjqjqjqjqjqjqjqjqjqj
qjqjqjqjqjqjqjqjqjqjqjqjqjqjqjqjqjqjqjRnRnRnRnRnRnRnRnRnRnRnRnRnRnRnqjqjqjqjqjqjqjqjqjqjqjqjqjqjqjqj
qjqjqjqjqjqjqjqjqjqjqjqjqjqjqjqjqjqjRnRnRnRnRnRnRnRnRnRnRnRnRnRnRnRnRnqjqjqjqjqjqjqjqjqjqjqjqjqjqjqj
qjqjqjqjqjqjqjqjqjqjqjqjqjqjqjqjqjRnRnRnRnRnRnRnRnRnRnRnltltltltltRnRnRnRnqjqjqjqjqjqjqjqjqjqjqjqjqj
qjqjqjqjqjqjqjqjqjqjqjqjqjqjqjqjqjRnRnRnltltltltltRnRnRnltIDudqSltRnRnRnRnRnqjqjqjqjqjqjqjqjqjqjqjqj
qjqjqjqjqjqjqjqjqjqjqjqjqjqjqjqjqjRnRnRnltKZltjLltltltltltIDeJIfltRnRnRnRnRnqjqjqjqjqjqjqjqjqjqjqjqj
qjqjqjqjqjqjqjqjqjqjqjqjqjqjqjqjqjRnRnRnltgHfSllltmvcRsRltFloergltRnRnRnRnRnqjqjqjqjqjqjqjqjqjqjqjqj
qjqjqjqjqjqjqjqjqjqjqjqjqjqjqjqjqjRnRnRnltBGOkkqxPRkEidsltwPuxXpltRnRnRnRnRnRnqjqjqjqjqjqjqjqjqjqjqj
qjqjqjqjqjqjqjqjqjqjqjqjqjqjqjqjqjRnRnRnlteJXLMLoILBiXIoltbfeJmGltRnRnRnRnRnRnqjqjqjqjqjqjqjqjqjqjqj
qjqjqjqjqjqjqjqjqjqjqjqjqjqjqjqjqjRnRnRnlteJeJhVxPxPvcYyxPajjZsGltltltRnRnRnRnqjqjqjqjqjqjqjqjqjqjqj
qjqjqjqjqjqjqjqjqjqjqjqjqjqjqjqjqjqjRnRnltwaNzuXqLEmOmAhDguYXeIlfFwmltRnRnRnqjqjqjqjqjqjqjqjqjqjqjqj
qjqjqjqjqjqjqjqjqjqjqjqjqjqjqjqjqjqjRnRnltnRDYiCDZqwSpYbDzujviaOIlvwltRnRnRnqjqjqjqjqjqjqjqjqjqjqjqj
qjqjqjqjqjqjqjqjqjqjqjqjqjqjqjqjqjqjqjRnltNzNzeJNWAhmzAhltcGQHQWrcWultRnqjqjqjqjqjqjqjqjqjqjqjqjqjqj
qjqjqjqjqjqjqjqjqjqjqjqjqjqjqjqjqjqjqjqjVjeJeJXUltGWlteRyFoXltltltltltRnqjqjqjqjqjqjqjqjqjqjqjqjqjqj
qjqjqjqjqjqjqjqjqjqjqjqjqjqjqjqjqjqjqjqjjBfUtzASlthZQBqjqjcIqjqjqjqjqjqjqjqjqjqjqjqjqjqjqjqjqjqjqjqj
qjqjqjqjqjqjqjqjqjqjqjqjqjqjqjqjqjqjqjqjqjqjqjqjBZKWhzqjqjqjqjqjqjqjqjqjqjqjqjqjqjqjqjqjqjqjqjqjqjqj
qjqjqjqjqjqjqjqjqjqjqjqjqjqjqjqjqjqjqjqjqjqjqjqjqjjnqjqjqjqjqjqjqjqjqjqjqjqjqjqjqjqjqjqjqjqjqjqjqjqj
qjqjqjqjqjqjqjqjqjqjqjqjqjqjqjqjqjqjqjqjqjqjqjqjqjqjqjqjqjqjqjqjqjqjqjqjqjqjqjqjqjqjqjqjqjqjqjqjqjqj
qjqjqjqjqjqjqjqjqjqjqjqjqjqjqjqjqjqjqjqjqjqjqjqjqjqjqjqjqjqjqjqjqjqjqjqjqjqjqjqjqjqjqjqjqjqjqjqjqjqj
qjqjqjqjqjqjqjqjqjqjqjqjqjqjqjqjqjqjqjqjqjqjqjqjqjqjqjqjqjqjqjqjqjqjqjqjqjqjqjqjqjqjqjqjqjqjqjqjqjqj
qjqjqjqjqjqjqjqjqjqjqjqjqjqjqjqjqjqjqjqjqjqjqjqjqjqjqjqjqjqjqjqjqjqjqjqjqjqjqjqjqjqjqjqjqjqjqjqjqjqj
qjqjqjqjqjqjqjqjqjqjqjqjqjqjqjqjqjqjqjqjqjqjqjqjqjqjqjqjqjqjqjqjqjqjqjqjqjqjqjqjqjqjqjqjqjqjqjqjqjqj
qjqjqjqjqjqjqjqjqjqjqjqjqjqjqjqjqjqjqjqjqjqjqjqjqjqjqjqjqjqjqjqjqjqjqjqjqjqjqjqjqjqjqjqjqjqjqjqjqjqj
qjqjqjqjqjqjqjqjqjqjqjqjqjqjqjqjqjqjqjqjqjqjqjqjqjqjqjqjqjqjqjqjqjqjqjqjqjqjqjqjqjqjqjqjqjqjqjqjqjqj
qjqjqjqjqjqjqjqjqjqjqjqjqjqjqjqjqjqjqjqjqjqjqjqjqjqjqjqjqjqjqjqjqjqjqjqjqjqjqjqjqjqjqjqjqjqjqjqjqjqj
qjqjqjqjqjqjqjqjqjqjqjqjqjqjqjqjqjqjqjqjqjqjqjqjqjqjqjqjqjqjqjqjqjqjqjqjqjqjqjqjqjqjqjqjqjqjqjqjqjqj
qjqjqjqjqjqjqjqjqjqjqjqjqjqjqjqjqjqjqjqjqjqjqjqjqjqjqjqjqjqjqjqjqjqjqjqjqjqjqjqjqjqjqjqjqjqjqjqjqjqj
qjqjqjqjqjqjqjqjqjqjqjqjqjqjqjqjqjqjqjqjqjqjqjqjqjqjqjqjqjqjqjqjqjqjqjqjqjqjqjqjqjqjqjqjqjqjqjqjqjqj
qjqjqjqjqjqjqjqjqjqjqjqjqjqjqjqjqjqjqjqjqjqjqjqjqjqjqjqjqjqjqjqjqjqjqjqjqjqjqjqjqjqjqjqjqjqjqjqjqjqj
qjqjqjqjqjqjqjqjqjqjqjqjqjqjqjqjqjqjqjqjqjqjqjqjqjqjqjqjqjqjqjqjqjqjqjqjqjqjqjqjqjqjqjqjqjqjqjqjqjqj
qjqjqjqjqjqjqjqjqjqjqjqjqjqjqjqjqjqjqjqjqjqjqjqjqjqjqjqjqjqjqjqjqjqjqjqjqjqjqjqjqjqjqjqjqjqjqjqjqjqj
qjqjqjqjqjqjqjqjqjqjqjqjqjqjqjqjqjqjqjqjqjqjqjqjqjqjqjqjqjqjqjqjqjqjqjqjqjqjqjqjqjqjqjqjqjqjqjqjqjqj
qjqjqjqjqjqjqjqjqjqjqjqjqjqjqjqjqjqjqjqjqjqjqjqjqjqjqjqjqjqjqjqjqjqjqjqjqjqjqjqjqjqjqjqjqjqjqjqjqjqj
qjqjqjqjqjqjqjqjqjqjqjqjqjqjqjqjqjqjqjqjqjqjqjqjqjqjqjqjqjqjqjqjqjqjqjqjqjqjqjqjqjqjqjqjqjqjqjqjqjqj
qjqjqjqjqjqjqjqjqjqjqjqjqjqjqjqjqjqjqjqjqjqjqjqjqjqjqjqjqjqjqjqjqjqjqjqjqjqjqjqjqjqjqjqjqjqjqjqjqjqj
qjqjqjqjqjqjqjqjqjqjqjqjqjqjqjqjqjqjqjqjqjqjqjqjqjqjqjqjqjqjqjqjqjqjqjqjqjqjqjqjqjqjqjqjqjqjqjqjqjqj
qjqjqjqjqjqjqjqjqjqjqjqjqjqjqjqjqjqjqjqjqjqjqjqjqjqjqjqjqjqjqjqjqjqjqjqjqjqjqjqjqjqjqjqjqjqjqjqjqjqj
qjqjqjqjqjqjqjqjqjqjqjqjqjqjqjqjqjqjqjqjqjqjqjqjqjqjqjqjqjqjqjqjqjqjqjqjqjqjqjqjqjqjqjqjqjqjqjqjqjqj
qjqjqjqjqjqjqjqjqjqjqjqjqjqjqjqjqjqjqjqjqjqjqjqjqjqjqjqjqjqjqjqjqjqjqjqjqjqjqjqjqjqjqjqjqjqjqjqjqjqj
qjqjqjqjqjqjqjqjqjqjqjqjqjqjqjqjqjqjqjqjqjqjqjqjqjqjqjqjqjqjqjqjqjqjqjqjqjqjqjqjqjqjqjqjqjqjqjqjqjqj
"}
