//MAP CONVERTED BY dmm2tgm.py THIS HEADER COMMENT PREVENTS RECONVERSION, DO NOT REMOVE
"ar" = (
/obj/structure/alien/weeds,
/obj/structure/alien/egg/burst,
/obj/item/clothing/mask/facehugger/impregnated,
/obj/effect/decal/cleanable/blood/gibs/torso,
/obj/effect/decal/cleanable/blood/gibs/limb,
/obj/effect/decal/cleanable/blood/gibs/down,
/turf/open/floor/planetary/dirt/jungle,
/area/ruin/unpowered)
"ez" = (
/turf/open/floor/planetary/dirt/jungle,
/area/ruin/unpowered)
"eK" = (
/obj/structure/alien/resin/wall,
/obj/structure/alien/resin/wall,
/obj/structure/alien/resin/wall,
/obj/structure/alien/weeds,
/turf/open/floor/planetary/dirt/jungle,
/area/ruin/unpowered)
"eY" = (
/obj/structure/alien/weeds,
/obj/structure/bed/nest,
/obj/effect/mapping_helpers/dead_body_placer,
/turf/open/floor/planetary/dirt/jungle,
/area/ruin/unpowered)
"fp" = (
/turf/template_noop,
/area/template_noop)
"fw" = (
/obj/structure/alien/weeds,
/mob/living/simple_animal/hostile/alien/drone,
/obj/item/ammo_casing/caseless/rocket/hedp,
/turf/open/floor/planetary/dirt/jungle,
/area/ruin/unpowered)
"fC" = (
/obj/structure/alien/weeds,
/obj/structure/alien/weeds/node,
/obj/effect/decal/cleanable/blood/gibs/torso,
/obj/effect/decal/cleanable/blood/gibs/down,
/obj/item/storage/backpack/duffelbag/syndie/med/medicalbundle,
/turf/open/floor/planetary/dirt/jungle,
/area/ruin/unpowered)
"fT" = (
/obj/structure/alien/weeds,
/obj/structure/alien/weeds/node,
/obj/structure/alien/egg/grown,
/turf/open/floor/planetary/dirt/jungle/dark,
/area/ruin/unpowered)
"ga" = (
/obj/structure/alien/weeds,
/obj/structure/alien/egg/burst,
/obj/item/clothing/mask/facehugger/impregnated,
/turf/open/floor/planetary/dirt/jungle,
/area/ruin/unpowered)
"gF" = (
/obj/structure/alien/weeds,
/obj/effect/decal/cleanable/vomit/old,
/turf/open/floor/planetary/dirt/jungle,
/area/ruin/unpowered)
"gN" = (
/obj/structure/alien/resin/wall,
/obj/structure/alien/weeds,
/turf/open/floor/planetary/dirt/jungle,
/area/ruin/unpowered)
"gX" = (
/obj/structure/alien/weeds,
/obj/structure/alien/weeds/node,
/turf/open/floor/planetary/dirt/dark,
/area/ruin/unpowered)
"hZ" = (
/obj/structure/alien/weeds,
/obj/structure/alien/weeds,
/obj/structure/alien/weeds/node,
/turf/open/floor/planetary/dirt/jungle,
/area/ruin/unpowered)
"ik" = (
/obj/structure/alien/weeds,
/obj/structure/bed/nest,
/obj/effect/mapping_helpers/dead_body_placer,
/turf/open/floor/planetary/dirt/jungle/dark,
/area/ruin/unpowered)
"it" = (
/obj/structure/alien/weeds,
/turf/open/floor/planetary/dirt/jungle,
/area/ruin/unpowered)
"iu" = (
/obj/structure/alien/weeds,
/mob/living/simple_animal/hostile/alien,
/turf/open/floor/planetary/dirt/jungle,
/area/ruin/unpowered)
"jT" = (
/obj/structure/alien/weeds,
/obj/structure/alien/weeds/node,
/turf/open/floor/planetary/dirt/jungle,
/area/ruin/unpowered)
"ka" = (
/obj/structure/alien/weeds,
/obj/structure/bed/nest,
/obj/item/ammo_box/magazine/m75,
/obj/item/ammo_box/magazine/m75,
/turf/open/floor/planetary/dirt/jungle,
/area/ruin/unpowered)
"kj" = (
/obj/structure/alien/weeds,
/obj/structure/alien/weeds,
/obj/item/storage/box/bodybags,
/turf/open/floor/planetary/dirt/jungle,
/area/ruin/unpowered)
"kG" = (
/obj/structure/alien/weeds,
/obj/structure/alien/weeds,
/mob/living/simple_animal/hostile/alien/drone,
/turf/open/floor/planetary/dirt/jungle,
/area/ruin/unpowered)
"kY" = (
/obj/structure/alien/weeds,
/obj/structure/bed/nest,
/obj/item/clothing/mask/facehugger/impregnated,
/obj/effect/mapping_helpers/dead_body_placer,
/obj/effect/spawner/lootdrop/space/cashmoney,
/turf/open/floor/planetary/dirt/jungle/dark,
/area/ruin/unpowered)
"lj" = (
/obj/structure/alien/weeds,
/obj/structure/alien/weeds,
/obj/structure/alien/weeds/node,
/turf/open/floor/planetary/dirt/jungle/dark,
/area/ruin/unpowered)
"lk" = (
/obj/structure/alien/weeds,
/obj/structure/alien/egg/grown,
/turf/open/floor/planetary/dirt/jungle,
/area/ruin/unpowered)
"lr" = (
/obj/effect/decal/cleanable/blood/splatter,
/obj/effect/decal/cleanable/blood/gibs/up,
/turf/open/floor/planetary/dirt/dark,
/area/ruin/unpowered)
"lR" = (
/obj/structure/alien/weeds,
/obj/structure/bed/nest,
/obj/item/clothing/mask/facehugger/impregnated,
/obj/effect/mapping_helpers/dead_body_placer,
/turf/open/floor/planetary/dirt/jungle,
/area/ruin/unpowered)
"mm" = (
/obj/structure/alien/resin/wall,
/obj/structure/alien/weeds,
/obj/structure/alien/weeds,
/obj/structure/alien/weeds,
/turf/open/floor/planetary/dirt/jungle,
/area/ruin/unpowered)
"nk" = (
/obj/structure/alien/weeds,
/obj/effect/decal/cleanable/blood/footprints{
	dir = 4
	},
/turf/open/floor/planetary/dirt/jungle,
/area/ruin/unpowered)
"nl" = (
/obj/structure/flora/junglebush/b,
/turf/template_noop,
/area/template_noop)
"nV" = (
/obj/structure/flora/grass/jungle,
/turf/template_noop,
/area/template_noop)
"nX" = (
/obj/structure/alien/weeds,
/mob/living/simple_animal/hostile/alien/queen/large,
/turf/open/floor/planetary/dirt/jungle,
/area/ruin/unpowered)
"pG" = (
/obj/structure/flora/rock/pile/largejungle,
/turf/template_noop,
/area/template_noop)
"qp" = (
/obj/structure/alien/weeds,
/obj/item/gun/energy/laser/scatter/shotty,
/turf/open/floor/planetary/dirt/jungle/dark,
/area/ruin/unpowered)
"qO" = (
/obj/structure/flora/junglebush/c,
/turf/open/floor/planetary/dirt/jungle,
/area/ruin/unpowered)
"rt" = (
/obj/structure/alien/resin,
/obj/structure/alien/resin/wall,
/turf/open/floor/planetary/dirt/jungle,
/area/ruin/unpowered)
"rx" = (
/obj/structure/alien/weeds,
/obj/structure/alien/weeds,
/obj/structure/alien/egg/burst,
/turf/open/floor/planetary/dirt/jungle/dark,
/area/ruin/unpowered)
"rB" = (
/obj/structure/alien/weeds,
/mob/living/simple_animal/hostile/alien/drone,
/turf/open/floor/planetary/dirt/jungle,
/area/ruin/unpowered)
"se" = (
/obj/structure/alien/weeds,
/obj/structure/alien/egg,
/turf/open/floor/planetary/dirt/jungle,
/area/ruin/unpowered)
"sw" = (
/obj/structure/alien/weeds,
/obj/structure/alien/egg/grown,
/turf/open/floor/planetary/dirt/jungle/dark,
/area/ruin/unpowered)
"sy" = (
/obj/structure/alien/weeds,
/obj/structure/bed/nest,
/obj/item/clothing/mask/facehugger/impregnated,
/turf/open/floor/planetary/dirt/jungle,
/area/ruin/unpowered)
"sK" = (
/obj/structure/alien/weeds,
/obj/structure/bed/nest,
/obj/effect/gibspawner/human,
/obj/effect/decal/cleanable/blood/gibs/down,
/turf/open/floor/planetary/dirt/jungle,
/area/ruin/unpowered)
"sP" = (
/obj/structure/alien/weeds,
/obj/structure/alien/weeds,
/mob/living/simple_animal/hostile/alien/drone,
/turf/open/floor/planetary/dirt/jungle/dark,
/area/ruin/unpowered)
"tF" = (
/obj/structure/flora/grass/jungle/b,
/turf/open/floor/planetary/dirt/jungle,
/area/ruin/unpowered)
"tO" = (
/turf/closed/mineral/random/jungle,
/area/template_noop)
"tP" = (
/obj/structure/alien/weeds,
/obj/effect/decal/cleanable/blood/gibs/up,
/obj/effect/decal/cleanable/blood/gibs/down,
/turf/open/floor/planetary/dirt/jungle,
/area/ruin/unpowered)
"uV" = (
/obj/structure/alien/resin/wall,
/obj/structure/alien/weeds,
/obj/structure/alien/weeds,
/turf/open/floor/planetary/dirt/jungle/dark,
/area/ruin/unpowered)
"vm" = (
/obj/structure/alien/resin/wall,
/obj/structure/alien/resin/wall,
/obj/structure/alien/weeds,
/turf/open/floor/planetary/dirt/jungle,
/area/ruin/unpowered)
"vQ" = (
/obj/structure/alien/weeds,
/obj/structure/alien/egg/grown,
/obj/item/clothing/mask/facehugger,
/turf/open/floor/planetary/dirt/jungle,
/area/ruin/unpowered)
"xg" = (
/obj/structure/alien/weeds,
/obj/structure/alien/weeds,
/obj/structure/alien/egg,
/turf/open/floor/planetary/dirt/jungle,
/area/ruin/unpowered)
"xn" = (
/obj/structure/alien/weeds,
/obj/structure/bed/nest,
/turf/open/floor/planetary/dirt/jungle,
/area/ruin/unpowered)
"xw" = (
/obj/structure/alien/weeds,
/mob/living/simple_animal/hostile/alien/sentinel,
/turf/open/floor/planetary/dirt/jungle,
/area/ruin/unpowered)
"xy" = (
/obj/structure/flora/junglebush/large,
/turf/template_noop,
/area/template_noop)
"xR" = (
/obj/structure/alien/resin/wall,
/obj/structure/alien/weeds,
/obj/structure/alien/weeds,
/obj/structure/alien/weeds/node,
/turf/open/floor/planetary/dirt/jungle,
/area/ruin/unpowered)
"yo" = (
/obj/structure/flora/rock/jungle,
/turf/template_noop,
/area/template_noop)
"yt" = (
/turf/closed/mineral/random/jungle,
/area/ruin/unpowered)
"yL" = (
/obj/structure/alien/resin,
/obj/structure/alien/resin/wall,
/obj/structure/alien/resin/wall,
/turf/open/floor/planetary/dirt/jungle,
/area/ruin/unpowered)
"zh" = (
/obj/structure/flora/tree/jungle,
/turf/template_noop,
/area/template_noop)
"zo" = (
/obj/effect/decal/cleanable/blood/footprints{
	dir = 4
	},
/turf/open/floor/planetary/dirt/jungle,
/area/ruin/unpowered)
"zr" = (
/obj/structure/alien/weeds,
/obj/structure/alien/weeds,
/obj/structure/alien/weeds/node,
/mob/living/simple_animal/hostile/alien/maid/barmaid,
/turf/open/floor/planetary/dirt/jungle,
/area/ruin/unpowered)
"zA" = (
/obj/structure/alien/weeds,
/obj/structure/alien/weeds,
/mob/living/simple_animal/hostile/alien/sentinel,
/turf/open/floor/planetary/dirt/jungle/dark,
/area/ruin/unpowered)
"zQ" = (
/obj/structure/alien/weeds,
/obj/structure/alien/weeds,
/obj/structure/bed/nest,
/obj/item/clothing/mask/facehugger/impregnated,
/obj/effect/gibspawner/human/bodypartless,
/turf/open/floor/planetary/dirt/jungle,
/area/ruin/unpowered)
"Ag" = (
/obj/structure/alien/weeds,
/obj/item/storage/box/syndie_kit/throwing_weapons,
/obj/item/grenade/syndieminibomb/concussion,
/turf/open/floor/planetary/dirt/jungle,
/area/ruin/unpowered)
"An" = (
/turf/open/floor/planetary/mud,
/area/ruin/unpowered)
"Ax" = (
/turf/open/floor/planetary/dirt/dark,
/area/ruin/unpowered)
"Ay" = (
/obj/structure/alien/weeds,
/obj/structure/bed/nest,
/obj/item/clothing/mask/facehugger/impregnated,
/obj/effect/gibspawner/human/bodypartless,
/obj/effect/mapping_helpers/dead_body_placer,
/turf/open/floor/planetary/dirt/jungle,
/area/ruin/unpowered)
"AO" = (
/obj/structure/alien/weeds,
/mob/living/simple_animal/hostile/alien/sentinel,
/turf/open/floor/planetary/dirt/jungle/dark,
/area/ruin/unpowered)
"AR" = (
/obj/structure/alien/weeds,
/obj/structure/alien/egg/burst,
/obj/item/clothing/mask/facehugger,
/turf/open/floor/planetary/dirt/jungle/dark,
/area/ruin/unpowered)
"BV" = (
/obj/structure/alien/weeds,
/obj/structure/alien/egg/burst,
/obj/item/clothing/mask/facehugger,
/turf/open/floor/planetary/dirt/jungle,
/area/ruin/unpowered)
"Cr" = (
/obj/effect/decal/cleanable/blood/splatter,
/obj/effect/decal/cleanable/blood/footprints{
	dir = 4
	},
/turf/open/floor/planetary/dirt/jungle,
/area/ruin/unpowered)
"Cu" = (
/obj/structure/alien/weeds,
/obj/structure/alien/weeds,
/obj/structure/bed/nest,
/obj/effect/mapping_helpers/dead_body_placer,
/turf/open/floor/planetary/dirt/jungle/dark,
/area/ruin/unpowered)
"CB" = (
/obj/structure/alien/weeds,
/turf/open/floor/planetary/dirt/jungle/dark,
/area/ruin/unpowered)
"CL" = (
/obj/structure/alien/resin/wall,
/obj/structure/alien/weeds,
/turf/open/floor/planetary/dirt/jungle/dark,
/area/ruin/unpowered)
"Ee" = (
/obj/structure/flora/grass/jungle,
/obj/structure/flora/grass/jungle,
/turf/open/floor/planetary/dirt/jungle,
/area/ruin/unpowered)
"Eh" = (
/obj/structure/alien/weeds,
/obj/structure/bed/nest,
/obj/effect/gibspawner/human,
/obj/effect/decal/cleanable/blood/gibs/torso,
/obj/effect/decal/cleanable/blood/gibs/limb,
/turf/open/floor/planetary/dirt/jungle,
/area/ruin/unpowered)
"EG" = (
/obj/structure/alien/weeds,
/obj/structure/alien/weeds,
/turf/open/floor/planetary/dirt/jungle/dark,
/area/ruin/unpowered)
"Fz" = (
/obj/structure/alien/weeds,
/obj/structure/alien/weeds,
/mob/living/simple_animal/hostile/alien,
/turf/open/floor/planetary/dirt/jungle,
/area/ruin/unpowered)
"FF" = (
/obj/structure/alien/weeds,
/obj/structure/alien/weeds/node,
/mob/living/simple_animal/hostile/alien/sentinel,
/turf/open/floor/planetary/dirt/jungle,
/area/ruin/unpowered)
"Hp" = (
/obj/structure/alien/weeds,
/obj/structure/alien/weeds,
/obj/item/gun/ballistic/automatic/gyropistol,
/obj/item/ammo_box/magazine/m75,
/turf/open/floor/planetary/dirt/jungle/dark,
/area/ruin/unpowered)
"HH" = (
/obj/structure/flora/junglebush/c,
/turf/template_noop,
/area/template_noop)
"HU" = (
/obj/structure/alien/weeds,
/obj/item/gun/ballistic/rocketlauncher,
/turf/open/floor/planetary/dirt/jungle,
/area/ruin/unpowered)
"Iz" = (
/obj/structure/flora/junglebush/large,
/turf/open/floor/planetary/dirt/jungle,
/area/ruin/unpowered)
"IP" = (
/obj/structure/alien/resin/wall,
/obj/structure/alien/resin/wall,
/turf/open/floor/planetary/dirt/jungle,
/area/ruin/unpowered)
"Js" = (
/obj/structure/alien/weeds,
/obj/structure/bed/nest,
/obj/effect/mapping_helpers/dead_body_placer,
/obj/effect/spawner/lootdrop/space/cashmoney,
/turf/open/floor/planetary/dirt/jungle,
/area/ruin/unpowered)
"JU" = (
/obj/structure/alien/weeds,
/obj/structure/alien/egg/burst,
/obj/item/clothing/mask/facehugger,
/obj/item/ammo_box/magazine/m75,
/obj/item/ammo_box/magazine/m75,
/turf/open/floor/planetary/dirt/jungle,
/area/ruin/unpowered)
"Kd" = (
/obj/structure/flora/grass/jungle,
/obj/structure/flora/grass/jungle/b,
/turf/open/floor/planetary/dirt/jungle,
/area/ruin/unpowered)
"Lm" = (
/obj/structure/alien/weeds,
/obj/structure/bed/nest,
/obj/item/clothing/mask/facehugger,
/obj/effect/mapping_helpers/dead_body_placer,
/obj/effect/spawner/lootdrop/space/cashmoney,
/turf/open/floor/planetary/dirt/jungle,
/area/ruin/unpowered)
"Lq" = (
/obj/structure/alien/weeds,
/obj/structure/bed/nest,
/obj/effect/mapping_helpers/dead_body_placer,
/obj/item/storage/backpack/duffelbag/syndie/c20rbundle,
/obj/effect/spawner/lootdrop/space/cashmoney,
/turf/open/floor/planetary/dirt/jungle/dark,
/area/ruin/unpowered)
"LS" = (
/obj/structure/alien/weeds,
/obj/structure/alien/egg/burst,
/turf/open/floor/planetary/dirt/jungle/dark,
/area/ruin/unpowered)
"LW" = (
/obj/structure/alien/resin/wall,
/obj/structure/alien/weeds,
/obj/structure/alien/weeds,
/turf/open/floor/planetary/dirt/jungle,
/area/ruin/unpowered)
"Mg" = (
/obj/structure/alien/weeds,
/obj/structure/alien/egg,
/turf/open/floor/planetary/dirt/jungle/dark,
/area/ruin/unpowered)
"MK" = (
/obj/structure/alien/weeds,
/obj/structure/alien/weeds,
/obj/structure/alien/weeds,
/turf/open/floor/planetary/dirt/jungle,
/area/ruin/unpowered)
"MZ" = (
/obj/structure/alien/weeds,
/obj/structure/bed/nest,
/obj/item/clothing/mask/facehugger/impregnated,
/obj/effect/mapping_helpers/dead_body_placer,
/obj/item/storage/bag/money,
/obj/effect/spawner/lootdrop/space/cashmoney,
/turf/open/floor/planetary/dirt/jungle/dark,
/area/ruin/unpowered)
"Nd" = (
/obj/structure/alien/weeds,
/obj/structure/alien/weeds/node,
/obj/structure/alien/egg/burst,
/obj/item/clothing/mask/facehugger/impregnated,
/obj/effect/decal/cleanable/blood/gibs/torso,
/obj/effect/decal/cleanable/blood/gibs/down,
/turf/open/floor/planetary/dirt/jungle,
/area/ruin/unpowered)
"Nn" = (
/obj/structure/alien/weeds,
/obj/structure/alien/weeds/node,
/obj/item/organ/body_egg/alien_embryo,
/turf/open/floor/planetary/dirt/jungle/dark,
/area/ruin/unpowered)
"Qp" = (
/obj/structure/flora/junglebush,
/obj/structure/flora/tree/jungle/small,
/turf/template_noop,
/area/template_noop)
"QZ" = (
/obj/structure/alien/resin/wall,
/turf/open/floor/planetary/dirt/jungle,
/area/ruin/unpowered)
"RA" = (
/obj/structure/alien/weeds,
/mob/living/simple_animal/hostile/alien/drone,
/turf/open/floor/planetary/dirt/jungle/dark,
/area/ruin/unpowered)
"RI" = (
/obj/structure/alien/weeds,
/obj/structure/alien/egg/grown,
/obj/item/clothing/mask/facehugger,
/turf/open/floor/planetary/dirt/jungle/dark,
/area/ruin/unpowered)
"RN" = (
/obj/structure/alien/weeds,
/obj/structure/alien/weeds,
/obj/structure/bed/nest,
/turf/open/floor/planetary/dirt/jungle,
/area/ruin/unpowered)
"Sk" = (
/obj/structure/alien/weeds,
/turf/open/floor/planetary/dirt/dark,
/area/ruin/unpowered)
"SU" = (
/turf/open/water/jungle,
/area/ruin/unpowered)
"Tm" = (
/obj/structure/alien/weeds,
/obj/structure/alien/egg/burst,
/obj/effect/decal/cleanable/blood/gibs/up,
/obj/item/soap/syndie,
/turf/open/floor/planetary/dirt/jungle,
/area/ruin/unpowered)
"Tq" = (
/obj/structure/alien/weeds,
/obj/structure/alien/egg/burst,
/obj/item/clothing/mask/facehugger/dead,
/turf/open/floor/planetary/dirt/jungle,
/area/ruin/unpowered)
"Tv" = (
/obj/structure/alien/weeds,
/obj/structure/alien/weeds,
/obj/item/storage/bag/money,
/turf/open/floor/planetary/dirt/jungle,
/area/ruin/unpowered)
"TB" = (
/obj/structure/flora/junglebush/c,
/obj/structure/flora/tree/jungle/small,
/turf/template_noop,
/area/template_noop)
"Ua" = (
/obj/structure/alien/weeds,
/obj/structure/alien/weeds,
/turf/open/floor/planetary/dirt/jungle,
/area/ruin/unpowered)
"Uq" = (
/obj/structure/alien/weeds,
/obj/structure/alien/weeds/node,
/turf/open/floor/planetary/dirt/jungle/dark,
/area/ruin/unpowered)
"Vk" = (
/obj/structure/alien/weeds,
/mob/living/simple_animal/hostile/alien/drone,
/obj/effect/mapping_helpers/dead_body_placer,
/turf/open/floor/planetary/dirt/jungle,
/area/ruin/unpowered)
"Vq" = (
/obj/structure/alien/weeds,
/obj/structure/alien/egg/burst,
/turf/open/floor/planetary/dirt/jungle,
/area/ruin/unpowered)
"VN" = (
/obj/structure/alien/weeds,
/obj/structure/alien/weeds,
/obj/structure/alien/weeds/node,
/turf/open/floor/planetary/dirt/dark,
/area/ruin/unpowered)
"Wr" = (
/obj/structure/alien/weeds,
/obj/structure/alien/weeds,
/obj/structure/alien/weeds/node,
/mob/living/simple_animal/hostile/alien/drone,
/turf/open/floor/planetary/dirt/jungle/dark,
/area/ruin/unpowered)
"WF" = (
/obj/structure/alien/weeds,
/obj/item/organ/body_egg/alien_embryo,
/turf/open/floor/planetary/dirt/jungle/dark,
/area/ruin/unpowered)
"XV" = (
/obj/structure/alien/weeds,
/obj/effect/decal/cleanable/blood/gibs/up,
/obj/effect/decal/cleanable/blood/gibs/limb,
/obj/item/gun/ballistic/shotgun/automatic/combat,
/turf/open/floor/planetary/dirt/jungle,
/area/ruin/unpowered)
"YK" = (
/obj/structure/alien/resin/wall,
/obj/structure/alien/weeds,
/obj/structure/alien/weeds/node,
/turf/open/floor/planetary/dirt/jungle,
/area/ruin/unpowered)
"YS" = (
/obj/structure/alien/weeds,
/obj/structure/alien/weeds,
/turf/open/floor/planetary/dirt/dark,
/area/ruin/unpowered)
"Zb" = (
/obj/structure/alien/resin/wall,
/obj/structure/alien/weeds/node,
/turf/open/floor/planetary/dirt/jungle,
/area/ruin/unpowered)
"ZB" = (
/obj/structure/alien/weeds,
/obj/structure/bed/nest,
/obj/effect/gibspawner/human/bodypartless,
/turf/open/floor/planetary/dirt/jungle,
/area/ruin/unpowered)
"ZS" = (
/obj/structure/alien/weeds,
/obj/structure/alien/weeds/node,
/obj/structure/bed/nest,
/obj/effect/mapping_helpers/dead_body_placer,
/obj/effect/spawner/lootdrop/space/cashmoney,
/turf/open/floor/planetary/dirt/jungle/dark,
/area/ruin/unpowered)

(1,1,1) = {"
fp
fp
fp
fp
fp
fp
fp
fp
fp
fp
fp
fp
fp
fp
fp
tO
tO
tO
tO
tO
tO
fp
fp
fp
fp
fp
fp
fp
fp
fp
fp
fp
fp
fp
fp
fp
fp
fp
fp
fp
"}
(2,1,1) = {"
fp
fp
fp
tO
tO
fp
fp
fp
fp
fp
fp
fp
tO
tO
tO
tO
tO
tO
tO
tO
tO
tO
tO
tO
fp
fp
tO
tO
tO
fp
fp
fp
fp
fp
fp
fp
fp
fp
fp
fp
"}
(3,1,1) = {"
fp
fp
tO
tO
tO
tO
tO
tO
tO
tO
tO
tO
tO
tO
QZ
QZ
QZ
QZ
QZ
QZ
QZ
QZ
tO
tO
tO
tO
tO
tO
tO
tO
tO
tO
tO
fp
fp
fp
fp
fp
fp
fp
"}
(4,1,1) = {"
fp
fp
tO
tO
tO
tO
tO
tO
QZ
QZ
tO
tO
tO
QZ
QZ
fw
QZ
QZ
QZ
QZ
QZ
QZ
QZ
QZ
QZ
QZ
QZ
QZ
QZ
QZ
QZ
QZ
tO
tO
tO
fp
fp
fp
fp
fp
"}
(5,1,1) = {"
fp
tO
tO
tO
tO
QZ
QZ
IP
QZ
QZ
QZ
QZ
QZ
QZ
HU
Ua
it
it
jT
it
Vq
eY
gN
gN
zQ
it
iu
gN
Ua
YS
Sk
QZ
QZ
QZ
tO
fp
fp
fp
fp
fp
"}
(6,1,1) = {"
tO
tO
tO
QZ
QZ
IP
eY
CB
AR
eY
ZB
ga
gN
it
gN
LW
gN
CB
CB
CL
it
gN
gN
ga
kj
it
gN
gN
MK
mm
YS
Sk
QZ
QZ
QZ
tO
fp
fp
fp
fp
"}
(7,1,1) = {"
tO
tO
tO
tO
IP
BV
it
Uq
CB
it
ga
it
gN
jT
ga
Ua
it
CB
CL
CL
it
jT
gN
iu
LW
jT
gN
gN
it
gN
it
Sk
Sk
QZ
QZ
tO
tO
fp
fp
fp
"}
(8,1,1) = {"
fp
tO
tO
tO
IP
Ag
rB
CL
CL
gN
gN
gN
gN
it
xn
LW
it
CL
CL
CB
it
gN
gN
gN
RN
it
CB
CB
CB
gN
it
gX
Sk
AR
QZ
tO
tO
tO
tO
fp
"}
(9,1,1) = {"
fp
fp
tO
tO
tO
QZ
gN
gN
it
it
it
gN
gN
gN
gN
LW
gN
gN
it
it
gN
gN
gN
gN
LW
CB
CB
CB
CB
gN
it
it
EG
CB
QZ
tO
tO
tO
fp
fp
"}
(10,1,1) = {"
fp
fp
fp
tO
tO
QZ
AO
CB
CB
it
it
eY
gN
gN
gN
zA
it
gN
it
gN
gN
CB
it
gN
LW
gN
CB
CB
CB
gN
it
gN
gN
Fz
QZ
tO
tO
fp
fp
fp
"}
(11,1,1) = {"
fp
tO
tO
tO
tO
QZ
CB
Uq
CL
gN
gN
gN
gN
gN
gN
Tv
Js
gN
it
gN
gN
Uq
EG
CB
LW
gN
gN
gN
jT
gN
it
Ua
gN
gN
QZ
tO
fp
fp
fp
fp
"}
(12,1,1) = {"
fp
tO
tO
tO
tO
QZ
CB
CL
RA
gN
gN
gN
gN
gN
gN
EG
CB
RI
it
gN
gN
CB
CL
CB
LW
Vq
ZB
gN
it
gN
it
VN
YS
gN
QZ
tO
fp
fp
fp
fp
"}
(13,1,1) = {"
fp
fp
fp
tO
tO
QZ
CB
CL
CB
it
gN
vm
fT
kY
gN
Wr
Mg
it
it
gN
gN
it
gN
it
hZ
it
it
it
it
gN
QZ
it
gF
nk
QZ
tO
fp
fp
fp
fp
"}
(14,1,1) = {"
fp
fp
fp
tO
QZ
QZ
CB
CL
CL
it
gN
gN
CB
CB
gN
rx
WF
xn
it
gN
gN
ga
rB
gN
Ua
it
it
gN
gN
gN
yL
rt
rt
Cr
yL
tO
fp
fp
fp
fp
"}
(15,1,1) = {"
fp
fp
tO
tO
QZ
QZ
jT
rB
CL
it
gN
gN
MZ
Nn
it
xg
lk
jT
it
gN
vm
sy
gN
it
Ua
gN
gN
gN
gN
gN
rt
yt
Ax
zo
rt
tO
tO
fp
fp
fp
"}
(16,1,1) = {"
fp
fp
tO
tO
QZ
QZ
jT
gN
it
jT
gN
gN
sw
Mg
Lm
Ua
nX
se
it
gN
gN
gN
xn
it
LW
gN
it
it
it
lR
rt
yt
lr
An
An
tO
tO
nV
yo
fp
"}
(17,1,1) = {"
fp
fp
tO
QZ
gN
it
it
gN
it
gN
gN
gN
Mg
ik
lk
Ua
jT
it
vQ
QZ
gN
gN
Vq
it
Ua
it
jT
gN
it
Tq
rt
yt
yt
An
An
An
tO
fp
pG
fp
"}
(18,1,1) = {"
fp
fp
tO
QZ
gN
it
gN
xn
ga
it
gN
gN
qp
Mg
eY
kG
CB
CB
ZS
gN
gN
it
it
gN
LW
gN
gN
it
it
it
rt
yt
yt
yt
SU
SU
tO
fp
fp
fp
"}
(19,1,1) = {"
fp
fp
tO
QZ
gN
jT
it
gN
it
it
gN
gN
gN
xw
jT
Ua
Mg
CB
AO
gN
vm
it
gN
jT
Ua
it
CB
CB
gN
it
rt
yt
yt
yt
SU
SU
tO
fp
nl
fp
"}
(20,1,1) = {"
fp
fp
tO
QZ
gN
it
it
it
gN
it
eY
gN
vm
gN
gN
it
CB
Uq
LS
gN
gN
Vq
it
BV
LW
gN
CB
Uq
gN
it
rt
yt
An
An
SU
SU
tO
fp
TB
fp
"}
(21,1,1) = {"
fp
fp
tO
QZ
gN
it
it
jT
it
it
BV
gN
gN
gN
gN
vm
sw
Lq
CL
gN
gN
sy
lR
gN
LW
eY
CB
CL
rB
CB
rt
yt
An
An
An
An
tO
fp
fp
fp
"}
(22,1,1) = {"
fp
fp
tO
QZ
it
it
gN
gN
xw
it
it
it
it
jT
gN
gN
vm
gN
gN
gN
vm
gN
gN
gN
Ua
LS
CB
gN
gN
CB
rt
yt
ez
yt
yt
yt
tO
fp
fp
fp
"}
(23,1,1) = {"
fp
fp
tO
QZ
it
gN
gN
gN
gN
gN
gN
gN
gN
it
it
it
gN
gN
gN
gN
gN
rB
it
it
Ua
ik
CB
gN
FF
CB
rt
yt
Ee
Kd
yt
yt
tO
HH
fp
fp
"}
(24,1,1) = {"
fp
fp
tO
QZ
jT
it
Vk
gN
tP
sK
fC
XV
gN
gN
YK
jT
jT
it
ka
JU
gN
gN
gN
jT
LW
CL
CB
gN
Ay
LS
rt
yt
Kd
Iz
tF
tF
qO
fp
Qp
fp
"}
(25,1,1) = {"
fp
fp
tO
QZ
it
it
eK
gN
gN
ar
Tm
sK
Eh
Nd
YK
xR
LW
Ua
EG
EG
lj
EG
EG
LW
Ua
CB
Uq
it
QZ
QZ
rt
yt
yt
ez
ez
qO
tF
xy
fp
fp
"}
(26,1,1) = {"
fp
fp
tO
tO
QZ
QZ
QZ
QZ
QZ
QZ
QZ
QZ
QZ
QZ
Zb
zr
LW
LW
Hp
sP
uV
Cu
EG
Ua
Ua
eY
BV
gN
QZ
tO
tO
tO
tO
tO
tO
tO
tO
fp
fp
fp
"}
(27,1,1) = {"
fp
fp
tO
tO
tO
tO
tO
tO
tO
tO
tO
tO
tO
tO
tO
QZ
QZ
QZ
QZ
QZ
QZ
QZ
IP
QZ
QZ
QZ
QZ
QZ
tO
tO
tO
tO
tO
tO
tO
tO
fp
fp
zh
fp
"}
(28,1,1) = {"
fp
fp
tO
tO
fp
fp
tO
tO
tO
tO
tO
tO
fp
fp
tO
tO
tO
tO
tO
tO
tO
tO
tO
tO
tO
tO
tO
tO
tO
tO
tO
tO
tO
tO
tO
fp
fp
fp
fp
fp
"}
(29,1,1) = {"
fp
fp
fp
fp
fp
fp
fp
fp
fp
fp
fp
fp
fp
fp
fp
fp
fp
fp
fp
fp
fp
fp
fp
fp
fp
fp
fp
fp
fp
tO
fp
fp
fp
fp
fp
fp
fp
fp
fp
fp
"}
(30,1,1) = {"
fp
fp
fp
fp
fp
fp
fp
fp
fp
fp
fp
fp
fp
fp
fp
fp
fp
fp
fp
fp
fp
fp
fp
fp
fp
fp
fp
fp
fp
fp
fp
fp
fp
fp
fp
fp
fp
fp
fp
fp
"}
