//MAP CONVERTED BY dmm2tgm.py THIS HEADER COMMENT PREVENTS RECONVERSION, DO NOT REMOVE
"a" = (
/turf/template_noop,
/area/template_noop)
"b" = (
/mob/living/simple_animal/hostile/netherworld,
/obj/effect/decal/cleanable/greenglow/ecto,
/obj/effect/decal/cleanable/dirt,
/turf/open/floor/engine,
/area/ruin/unpowered)
"c" = (
/obj/structure/window/reinforced/fulltile,
/turf/open/floor/plating,
/area/ruin/unpowered)
"d" = (
/obj/effect/spawner/clear,
/turf/template_noop,
/area/template_noop)
"e" = (
/obj/effect/decal/cleanable/dirt,
/obj/structure/closet/emcloset,
/turf/open/floor/iron/white,
/area/ruin/unpowered)
"f" = (
/obj/effect/decal/cleanable/blood/old,
/obj/effect/decal/cleanable/dirt,
/turf/open/floor/iron/white,
/area/ruin/unpowered)
"g" = (
/mob/living/simple_animal/hostile/netherworld,
/obj/effect/decal/cleanable/dirt,
/turf/open/floor/engine,
/area/ruin/unpowered)
"h" = (
/obj/effect/spawner/lootdrop/maintenance,
/obj/effect/decal/cleanable/dirt,
/turf/open/floor/carpet,
/area/ruin/unpowered)
"i" = (
/obj/effect/decal/cleanable/dirt,
/turf/open/floor/iron/white,
/area/ruin/unpowered)
"j" = (
/obj/structure/closet/crate/trashcart,
/obj/effect/spawner/clear,
/turf/template_noop,
/area/template_noop)
"k" = (
/obj/effect/spawner/lootdrop/maintenance,
/obj/structure/chair/office,
/obj/effect/decal/cleanable/dirt,
/turf/open/floor/carpet,
/area/ruin/unpowered)
"l" = (
/obj/structure/bookcase/manuals/research_and_development,
/obj/effect/decal/cleanable/dirt,
/turf/open/floor/carpet,
/area/ruin/unpowered)
"m" = (
/obj/item/raw_anomaly_core/random,
/obj/effect/decal/cleanable/dirt,
/obj/effect/decal/cleanable/blood/old,
/turf/open/floor/engine,
/area/ruin/unpowered)
"n" = (
/obj/effect/spawner/lootdrop/away_loot,
/obj/effect/decal/cleanable/dirt,
/turf/open/floor/engine,
/area/ruin/unpowered)
"o" = (
/obj/machinery/door/airlock/vault,
/obj/effect/decal/cleanable/dirt,
/turf/open/floor/engine,
/area/ruin/unpowered)
"p" = (
/obj/machinery/door/airlock/external,
/turf/open/floor/plating,
/area/ruin/unpowered)
"r" = (
/obj/machinery/door/airlock,
/obj/effect/decal/cleanable/dirt,
/turf/open/floor/iron/white,
/area/ruin/unpowered)
"s" = (
/obj/effect/decal/cleanable/dirt,
/obj/effect/mob_spawn/human/corpse/assistant,
/turf/open/floor/iron/white,
/area/ruin/unpowered)
"t" = (
/turf/closed/wall/r_wall,
/area/ruin/unpowered)
"u" = (
/obj/structure/table/wood,
/obj/machinery/microwave,
/obj/effect/decal/cleanable/dirt,
/turf/open/floor/carpet,
/area/ruin/unpowered)
"v" = (
/mob/living/simple_animal/hostile/asteroid/basilisk,
/obj/effect/decal/cleanable/greenglow/ecto,
/obj/effect/decal/cleanable/dirt,
/turf/open/floor/engine,
/area/ruin/unpowered)
"w" = (
/obj/structure/railing,
/obj/effect/decal/cleanable/dirt,
/turf/open/floor/iron/white,
/area/ruin/unpowered)
"x" = (
/obj/effect/decal/cleanable/cobweb/cobweb2,
/obj/effect/decal/cleanable/dirt,
/obj/structure/bed,
/turf/open/floor/engine,
/area/ruin/unpowered)
"y" = (
/obj/effect/decal/cleanable/blood/old,
/obj/effect/decal/cleanable/dirt,
/turf/open/floor/carpet,
/area/ruin/unpowered)
"z" = (
/obj/item/restraints/legcuffs/beartrap,
/turf/open/floor/plating,
/area/ruin/unpowered)
"A" = (
/obj/effect/spawner/clear,
/obj/structure/closet/crate,
/obj/effect/spawner/lootdrop/donkpockets,
/turf/template_noop,
/area/template_noop)
"C" = (
/obj/structure/table,
/obj/item/paper,
/obj/effect/spawner/lootdrop/contraband,
/obj/effect/decal/cleanable/dirt,
/turf/open/floor/iron/white,
/area/ruin/unpowered)
"D" = (
/obj/effect/decal/cleanable/dirt,
/obj/effect/decal/cleanable/blood/old,
/turf/open/floor/engine,
/area/ruin/unpowered)
"E" = (
/obj/effect/spawner/lootdrop/powercell,
/obj/item/storage/toolbox/emergency,
/obj/structure/rack,
/obj/effect/decal/cleanable/dirt,
/turf/open/floor/carpet,
/area/ruin/unpowered)
"F" = (
/obj/structure/rack,
/obj/effect/spawner/lootdrop/maintenance,
/obj/effect/spawner/lootdrop/scanner,
/obj/effect/spawner/lootdrop/scanner,
/obj/effect/spawner/lootdrop/scanner,
/obj/effect/decal/cleanable/dirt,
/turf/open/floor/iron/white,
/area/ruin/unpowered)
"G" = (
/obj/effect/spawner/clear,
/obj/effect/spawner/lootdrop/maintenance,
/turf/template_noop,
/area/template_noop)
"H" = (
/obj/item/restraints/legcuffs/beartrap,
/obj/machinery/door/airlock/vault,
/obj/effect/decal/cleanable/dirt,
/turf/open/floor/engine,
/area/ruin/unpowered)
"I" = (
/obj/effect/decal/cleanable/dirt,
/obj/structure/sign/warning/securearea{
	pixel_y = 32
	},
/turf/open/floor/iron/white,
/area/ruin/unpowered)
"J" = (
/obj/effect/decal/cleanable/dirt,
/turf/open/floor/engine,
/area/ruin/unpowered)
"K" = (
/obj/effect/spawner/lootdrop/maintenance,
/obj/effect/decal/cleanable/dirt,
/obj/machinery/light/directional/north,
/turf/open/floor/carpet,
/area/ruin/unpowered)
"L" = (
/obj/effect/decal/cleanable/dirt,
/turf/open/floor/plating,
/area/ruin/unpowered)
"M" = (
/obj/effect/decal/cleanable/greenglow/ecto,
/obj/effect/decal/cleanable/dirt,
/turf/open/floor/iron/white,
/area/ruin/unpowered)
"N" = (
/obj/structure/bed,
/obj/item/bedsheet/dorms,
/obj/effect/decal/cleanable/dirt,
/turf/open/floor/carpet,
/area/ruin/unpowered)
"O" = (
/obj/structure/chair/office,
/obj/effect/decal/cleanable/dirt,
/obj/machinery/light/directional/east,
/turf/open/floor/iron/white,
/area/ruin/unpowered)
"P" = (
/obj/effect/decal/cleanable/greenglow/ecto,
/obj/effect/decal/cleanable/dirt,
/turf/open/floor/carpet,
/area/ruin/unpowered)
"Q" = (
/obj/effect/spawner/clear,
/obj/machinery/power/floodlight,
/turf/template_noop,
/area/template_noop)
"R" = (
/obj/structure/extinguisher_cabinet/directional/west,
/obj/effect/decal/cleanable/blood/old,
/obj/effect/decal/cleanable/dirt,
/obj/item/reagent_containers/glass/bucket,
/obj/effect/decal/cleanable/vomit/old,
/turf/open/floor/carpet,
/area/ruin/unpowered)
"S" = (
/obj/effect/decal/cleanable/cobweb/cobweb2,
/obj/structure/table/wood,
/obj/item/flashlight/lamp/green,
/obj/effect/decal/cleanable/dirt,
/turf/open/floor/carpet,
/area/ruin/unpowered)
"T" = (
/obj/effect/spawner/lootdrop/away_loot,
/obj/effect/decal/cleanable/cobweb,
/obj/effect/decal/cleanable/dirt,
/turf/open/floor/engine,
/area/ruin/unpowered)
"U" = (
/turf/open/floor/plating,
/area/ruin/unpowered)
"V" = (
/obj/effect/decal/cleanable/dirt,
/obj/machinery/light/directional/west,
/turf/open/floor/iron/white,
/area/ruin/unpowered)
"W" = (
/obj/effect/spawner/lootdrop/maintenance,
/turf/template_noop,
/area/template_noop)
"X" = (
/obj/effect/spawner/clear,
/obj/structure/closet/crate,
/obj/effect/spawner/lootdrop/away_loot,
/turf/template_noop,
/area/template_noop)
"Y" = (
/obj/structure/table,
/obj/item/clothing/mask/gas,
/obj/effect/spawner/lootdrop/contraband,
/obj/effect/decal/cleanable/dirt,
/turf/open/floor/iron/white,
/area/ruin/unpowered)
"Z" = (
/obj/structure/table/wood,
/obj/item/paper,
/obj/effect/decal/cleanable/dirt,
/turf/open/floor/carpet,
/area/ruin/unpowered)

(1,1,1) = {"
a
a
a
a
a
a
W
a
a
a
d
a
a
"}
(2,1,1) = {"
a
t
t
t
t
t
t
t
t
t
p
t
a
"}
(3,1,1) = {"
a
t
T
g
H
V
e
F
t
z
U
t
a
"}
(4,1,1) = {"
W
t
n
b
c
f
M
i
p
L
z
t
a
"}
(5,1,1) = {"
a
t
t
t
t
I
s
t
t
t
t
t
a
"}
(6,1,1) = {"
a
t
m
J
o
M
i
t
w
R
u
t
a
"}
(7,1,1) = {"
a
t
x
D
c
i
i
t
l
k
Z
c
a
"}
(8,1,1) = {"
a
t
t
t
t
i
f
r
P
h
E
c
a
"}
(9,1,1) = {"
a
t
n
v
o
i
Y
t
K
y
h
c
a
"}
(10,1,1) = {"
a
t
J
n
c
O
C
t
S
N
N
t
a
"}
(11,1,1) = {"
a
t
t
t
t
t
t
t
t
t
t
t
a
"}
(12,1,1) = {"
a
t
d
d
t
Q
Q
t
A
X
j
t
W
"}
(13,1,1) = {"
a
d
d
d
d
d
d
d
d
G
G
G
a
"}
