//MAP CONVERTED BY dmm2tgm.py THIS HEADER COMMENT PREVENTS RECONVERSION, DO NOT REMOVE
"a" = (
/turf/closed/wall/mineral/titanium/survival,
/area/survivalpod)
"b" = (
/obj/structure/table,
/obj/item/cautery,
/turf/open/floor/pod,
/area/survivalpod)
"d" = (
/obj/effect/decal/cleanable/blood/tracks{
	dir = 4
	},
/obj/machinery/light/directional/south,
/turf/open/floor/pod,
/area/survivalpod)
"e" = (
/obj/structure/chair,
/obj/machinery/light/broken/directional/west,
/turf/open/floor/pod,
/area/survivalpod)
"f" = (
/obj/structure/table,
/obj/item/hemostat,
/turf/open/floor/pod,
/area/survivalpod)
"g" = (
/obj/effect/decal/cleanable/blood/tracks{
	dir = 9
	},
/turf/open/floor/pod,
/area/survivalpod)
"h" = (
/obj/effect/decal/cleanable/blood/drip,
/obj/effect/decal/cleanable/blood/tracks{
	dir = 4
	},
/turf/open/floor/pod,
/area/survivalpod)
"i" = (
/obj/structure/table,
/obj/item/food/pizzaslice/meat,
/turf/open/floor/pod,
/area/survivalpod)
"k" = (
/obj/effect/decal/cleanable/blood/drip,
/turf/open/floor/pod,
/area/survivalpod)
"l" = (
/obj/effect/decal/cleanable/blood/splatter,
/obj/structure/closet/secure_closet/medical2,
/turf/open/floor/pod,
/area/survivalpod)
"m" = (
/obj/structure/chair,
/obj/effect/mob_spawn/human/clown/corpse,
/obj/effect/decal/cleanable/blood,
/turf/open/floor/pod,
/area/survivalpod)
"o" = (
/obj/machinery/smartfridge/organ,
/turf/open/floor/pod,
/area/survivalpod)
"p" = (
/obj/effect/decal/cleanable/blood/tracks,
/turf/open/floor/pod,
/area/survivalpod)
"s" = (
/turf/open/floor/pod,
/area/survivalpod)
"u" = (
/obj/effect/turf_decal/mining/survival{
	dir = 8
	},
/turf/closed/wall/mineral/titanium/survival,
/area/survivalpod)
"v" = (
/obj/effect/turf_decal/mining/survival{
	dir = 1
	},
/turf/closed/wall/mineral/titanium/survival,
/area/survivalpod)
"w" = (
/obj/machinery/door/airlock/survival_pod,
/turf/open/floor/pod,
/area/survivalpod)
"x" = (
/obj/structure/reagent_dispensers/water_cooler,
/turf/open/floor/pod,
/area/survivalpod)
"A" = (
/obj/machinery/door/airlock/survival_pod/glass,
/turf/open/floor/pod,
/area/survivalpod)
"C" = (
/obj/effect/turf_decal/mining/survival,
/turf/closed/wall/mineral/titanium/survival,
/area/survivalpod)
"D" = (
/obj/effect/turf_decal/mining/survival{
	dir = 4
	},
/turf/closed/wall/mineral/titanium/survival,
/area/survivalpod)
"E" = (
/obj/structure/window/shuttle/survival_pod,
/obj/structure/grille,
/turf/open/floor/plating,
/area/survivalpod)
"F" = (
/obj/structure/table/optable,
/obj/effect/mob_spawn/human/miner,
/obj/effect/decal/cleanable/blood,
/turf/open/floor/pod,
/area/survivalpod)
"G" = (
/obj/machinery/door/airlock/survival_pod,
/obj/effect/decal/cleanable/blood/tracks{
	dir = 4
	},
/turf/open/floor/pod,
/area/survivalpod)
"H" = (
/obj/effect/decal/cleanable/blood/drip,
/obj/item/grown/bananapeel,
/turf/open/floor/pod,
/area/survivalpod)
"I" = (
/obj/effect/turf_decal/mining,
/turf/closed/wall/mineral/titanium/survival,
/area/survivalpod)
"K" = (
/obj/structure/table,
/obj/item/pizzabox{
	pixel_y = 7
	},
/obj/item/pizzabox{
	pixel_y = 11
	},
/turf/open/floor/pod,
/area/survivalpod)
"N" = (
/obj/structure/table,
/obj/item/retractor,
/turf/open/floor/pod,
/area/survivalpod)
"O" = (
/obj/effect/decal/cleanable/blood/gibs/limb{
	dir = 4
	},
/turf/open/floor/pod,
/area/survivalpod)
"P" = (
/obj/structure/table,
/obj/item/food/pizza/meat{
	pixel_y = 5
	},
/turf/open/floor/pod,
/area/survivalpod)
"Q" = (
/obj/structure/chair,
/obj/effect/decal/cleanable/blood/drip,
/turf/open/floor/pod,
/area/survivalpod)
"R" = (
/obj/structure/table,
/obj/item/surgical_drapes{
	pixel_x = 2;
	pixel_y = 7
	},
/turf/open/floor/pod,
/area/survivalpod)
"S" = (
/obj/effect/decal/cleanable/blood/splatter,
/turf/open/floor/pod,
/area/survivalpod)
"U" = (
/obj/effect/decal/cleanable/blood/footprints,
/turf/open/floor/pod,
/area/survivalpod)
"V" = (
/obj/structure/chair,
/turf/open/floor/pod,
/area/survivalpod)
"W" = (
/obj/item/melee/baton,
/obj/effect/decal/cleanable/blood/tracks{
	dir = 6
	},
/turf/open/floor/pod,
/area/survivalpod)
"Y" = (
/obj/item/scalpel/advanced,
/turf/open/floor/pod,
/area/survivalpod)

(1,1,1) = {"
a
a
u
a
a
a
u
a
w
a
a
"}
(2,1,1) = {"
a
k
e
V
a
f
i
k
O
l
a
"}
(3,1,1) = {"
v
s
V
V
E
K
S
s
Y
k
C
"}
(4,1,1) = {"
A
p
p
H
E
P
s
F
U
d
a
"}
(5,1,1) = {"
v
s
Q
m
E
b
k
s
g
W
I
"}
(6,1,1) = {"
a
x
V
V
a
R
N
s
h
o
a
"}
(7,1,1) = {"
a
a
D
a
a
a
D
a
G
a
a
"}
