//MAP CONVERTED BY dmm2tgm.py THIS HEADER COMMENT PREVENTS RECONVERSION, DO NOT REMOVE
"aa" = (
/turf/template_noop,
/area/template_noop)
"ab" = (
/obj/machinery/power/shieldwallgen/anchored,
/obj/structure/cable,
/turf/open/floor/plating/airless,
/area/ruin/space/has_grav/abandonedzoo)
"ac" = (
/obj/effect/spawner/structure/window/reinforced,
/obj/structure/cable,
/turf/open/floor/plating,
/area/ruin/space/has_grav/abandonedzoo)
"ag" = (
/obj/effect/spawner/structure/window/reinforced,
/turf/open/floor/plating,
/area/ruin/space/has_grav/abandonedzoo)
"ah" = (
/turf/closed/mineral/random,
/area/ruin/space/has_grav/abandonedzoo)
"ai" = (
/turf/open/floor/plating/asteroid,
/area/ruin/space/has_grav/abandonedzoo)
"aj" = (
/obj/structure/flora/rock,
/turf/open/floor/plating/asteroid,
/area/ruin/space/has_grav/abandonedzoo)
"al" = (
/obj/structure/flora/ausbushes/genericbush,
/turf/open/floor/grass,
/area/ruin/space/has_grav/abandonedzoo)
"ao" = (
/obj/structure/flora/ausbushes/lavendergrass,
/turf/open/floor/grass,
/area/ruin/space/has_grav/abandonedzoo)
"ap" = (
/mob/living/simple_animal/hostile/asteroid/goldgrub{
	will_burrow = 0
	},
/turf/open/floor/plating/asteroid,
/area/ruin/space/has_grav/abandonedzoo)
"aq" = (
/obj/structure/flora/ausbushes/grassybush,
/turf/open/floor/grass,
/area/ruin/space/has_grav/abandonedzoo)
"ar" = (
/obj/structure/flora/rock/pile,
/turf/open/floor/plating/asteroid,
/area/ruin/space/has_grav/abandonedzoo)
"as" = (
/mob/living/simple_animal/hostile/asteroid/basilisk,
/turf/open/floor/plating/asteroid,
/area/ruin/space/has_grav/abandonedzoo)
"at" = (
/turf/closed/wall/r_wall,
/area/ruin/space/has_grav/abandonedzoo)
"av" = (
/obj/structure/flora/ausbushes/brflowers,
/turf/open/floor/grass,
/area/ruin/space/has_grav/abandonedzoo)
"ay" = (
/obj/effect/turf_decal/tile/green{
	dir = 1
	},
/obj/effect/turf_decal/tile/green,
/obj/effect/turf_decal/tile/green{
	dir = 4
	},
/obj/effect/turf_decal/tile/green{
	dir = 8
	},
/turf/open/floor/iron/dark,
/area/ruin/space/has_grav/abandonedzoo)
"aA" = (
/obj/structure/flora/ausbushes/ywflowers,
/turf/open/floor/grass,
/area/ruin/space/has_grav/abandonedzoo)
"aC" = (
/obj/structure/flora/ausbushes/ppflowers,
/turf/open/floor/grass,
/area/ruin/space/has_grav/abandonedzoo)
"aD" = (
/obj/machinery/door/airlock/highsecurity{
	name = "Bio Containment";
	req_one_access_txt = "47"
	},
/obj/structure/cable,
/obj/effect/turf_decal/tile/neutral,
/obj/effect/turf_decal/tile/neutral{
	dir = 4
	},
/obj/effect/turf_decal/tile/neutral{
	dir = 1
	},
/obj/effect/turf_decal/tile/neutral{
	dir = 8
	},
/turf/open/floor/iron/dark,
/area/ruin/space/has_grav/abandonedzoo)
"aE" = (
/obj/machinery/power/shieldwallgen/anchored,
/obj/structure/cable,
/turf/open/floor/plating,
/area/ruin/space/has_grav/abandonedzoo)
"aG" = (
/obj/structure/table/reinforced,
/obj/item/clipboard,
/obj/item/clothing/mask/surgical,
/obj/item/razor,
/obj/machinery/light/directional/west,
/turf/open/floor/iron/dark/side{
	dir = 10
	},
/area/ruin/space/has_grav/abandonedzoo)
"aI" = (
/obj/effect/turf_decal/tile/green{
	dir = 1
	},
/obj/effect/turf_decal/tile/green,
/obj/effect/turf_decal/tile/green{
	dir = 4
	},
/obj/effect/turf_decal/tile/green{
	dir = 8
	},
/obj/structure/bed,
/obj/item/bedsheet/green,
/turf/open/floor/iron/dark,
/area/ruin/space/has_grav/abandonedzoo)
"aK" = (
/obj/structure/window/reinforced{
	dir = 4
	},
/turf/template_noop,
/area/template_noop)
"aL" = (
/obj/structure/cable,
/obj/effect/turf_decal/tile/neutral,
/obj/effect/turf_decal/tile/neutral{
	dir = 4
	},
/obj/effect/turf_decal/tile/neutral{
	dir = 1
	},
/obj/effect/turf_decal/tile/neutral{
	dir = 8
	},
/turf/open/floor/iron/dark,
/area/ruin/space/has_grav/abandonedzoo)
"aN" = (
/obj/structure/table/reinforced,
/obj/item/storage/box/syringes{
	pixel_x = 5;
	pixel_y = 5
	},
/obj/item/storage/box/beakers,
/obj/machinery/light/directional/east,
/turf/open/floor/iron/dark/side{
	dir = 4
	},
/area/ruin/space/has_grav/abandonedzoo)
"aO" = (
/obj/effect/turf_decal/tile/green{
	dir = 1
	},
/obj/effect/turf_decal/tile/green,
/obj/effect/turf_decal/tile/green{
	dir = 4
	},
/obj/effect/turf_decal/tile/green{
	dir = 8
	},
/obj/effect/decal/cleanable/dirt/dust,
/turf/open/floor/iron/dark,
/area/ruin/space/has_grav/abandonedzoo)
"aP" = (
/obj/structure/cable,
/obj/structure/frame/machine,
/turf/open/floor/plating,
/area/ruin/space/has_grav/abandonedzoo)
"aQ" = (
/obj/structure/window/reinforced{
	dir = 8
	},
/turf/template_noop,
/area/template_noop)
"aS" = (
/obj/structure/table/reinforced,
/obj/item/gun/energy/floragun,
/turf/open/floor/iron/dark/side{
	dir = 10
	},
/area/ruin/space/has_grav/abandonedzoo)
"aT" = (
/obj/structure/table/reinforced,
/obj/machinery/computer/med_data/laptop{
	dir = 8;
	pixel_y = 1
	},
/turf/open/floor/iron/dark/side{
	dir = 4
	},
/area/ruin/space/has_grav/abandonedzoo)
"aV" = (
/obj/effect/turf_decal/tile/green{
	dir = 8
	},
/obj/effect/turf_decal/tile/green{
	dir = 1
	},
/obj/effect/turf_decal/tile/green{
	dir = 4
	},
/obj/effect/turf_decal/tile/green,
/turf/open/floor/iron/dark,
/area/ruin/space/has_grav/abandonedzoo)
"aW" = (
/obj/machinery/power/apc/unlocked{
	dir = 8;
	environ = 0;
	lighting = 0;
	name = "Worn-out APC";
	pixel_x = -25
	},
/obj/structure/rack,
/obj/item/melee/baton/cattleprod,
/obj/effect/spawner/lootdrop/maintenance,
/obj/structure/cable,
/obj/effect/spawner/lootdrop,
/obj/machinery/light/directional/north,
/turf/open/floor/iron/dark/side{
	dir = 1
	},
/area/ruin/space/has_grav/abandonedzoo)
"aY" = (
/obj/structure/rack,
/obj/item/tank/internals/emergency_oxygen/double,
/obj/item/clothing/suit/space/hardsuit/medical,
/turf/open/floor/iron/dark/side{
	dir = 1
	},
/area/ruin/space/has_grav/abandonedzoo)
"aZ" = (
/obj/machinery/smartfridge/chemistry,
/turf/open/floor/iron/dark/corner{
	dir = 1
	},
/area/ruin/space/has_grav/abandonedzoo)
"bb" = (
/obj/machinery/door/airlock/hatch{
	name = "Bio-Research Station"
	},
/obj/effect/turf_decal/tile/green{
	dir = 1
	},
/obj/effect/turf_decal/tile/green,
/obj/effect/turf_decal/tile/green{
	dir = 4
	},
/obj/effect/turf_decal/tile/green{
	dir = 8
	},
/turf/open/floor/iron/dark,
/area/ruin/space/has_grav/abandonedzoo)
"bd" = (
/obj/structure/table/reinforced,
/obj/item/grenade/chem_grenade/antiweed{
	pixel_x = 3;
	pixel_y = 5
	},
/obj/item/grenade/chem_grenade/antiweed{
	pixel_x = 4
	},
/obj/item/grenade/chem_grenade/antiweed{
	pixel_x = -3;
	pixel_y = -1
	},
/obj/item/gun/syringe,
/turf/open/floor/iron/dark/corner{
	dir = 4
	},
/area/ruin/space/has_grav/abandonedzoo)
"be" = (
/obj/structure/table/reinforced,
/obj/item/cultivator,
/obj/item/shovel,
/obj/machinery/light/directional/north,
/turf/open/floor/iron/dark/side{
	dir = 1
	},
/area/ruin/space/has_grav/abandonedzoo)
"bf" = (
/obj/machinery/power/terminal,
/obj/effect/turf_decal/tile/green{
	dir = 1
	},
/obj/effect/turf_decal/tile/green,
/obj/effect/turf_decal/tile/green{
	dir = 4
	},
/obj/effect/turf_decal/tile/green{
	dir = 8
	},
/obj/structure/cable,
/turf/open/floor/iron/dark,
/area/ruin/space/has_grav/abandonedzoo)
"bh" = (
/obj/structure/table/reinforced,
/obj/item/folder,
/obj/item/gps/spaceruin,
/obj/effect/turf_decal/tile/green{
	dir = 8
	},
/obj/effect/turf_decal/tile/green,
/obj/effect/turf_decal/tile/green{
	dir = 4
	},
/obj/effect/turf_decal/tile/green{
	dir = 1
	},
/obj/effect/decal/cleanable/dirt/dust,
/turf/open/floor/iron/dark,
/area/ruin/space/has_grav/abandonedzoo)
"bi" = (
/obj/structure/table/reinforced,
/obj/item/reagent_containers/glass/bottle/random_virus,
/obj/item/reagent_containers/dropper,
/obj/effect/turf_decal/tile/green{
	dir = 8
	},
/obj/effect/turf_decal/tile/green,
/obj/effect/turf_decal/tile/green{
	dir = 4
	},
/obj/effect/turf_decal/tile/green{
	dir = 1
	},
/turf/open/floor/iron/dark,
/area/ruin/space/has_grav/abandonedzoo)
"bk" = (
/obj/effect/turf_decal/tile/green{
	dir = 1
	},
/obj/effect/turf_decal/tile/green,
/obj/effect/turf_decal/tile/green{
	dir = 4
	},
/obj/effect/turf_decal/tile/green{
	dir = 8
	},
/obj/structure/table/reinforced,
/obj/item/food/carrotfries,
/obj/structure/cable,
/turf/open/floor/iron/dark,
/area/ruin/space/has_grav/abandonedzoo)
"bl" = (
/obj/effect/turf_decal/tile/green{
	dir = 1
	},
/obj/effect/turf_decal/tile/green,
/obj/effect/turf_decal/tile/green{
	dir = 4
	},
/obj/effect/turf_decal/tile/green{
	dir = 8
	},
/obj/structure/cable,
/obj/structure/table/reinforced,
/obj/item/reagent_containers/glass/bottle/mutagen,
/obj/item/reagent_containers/hypospray/medipen/stimpack,
/turf/open/floor/iron/dark,
/area/ruin/space/has_grav/abandonedzoo)
"bm" = (
/obj/structure/reagent_dispensers/fueltank,
/obj/structure/cable,
/obj/machinery/light/directional/south,
/turf/open/floor/iron/dark/side,
/area/ruin/space/has_grav/abandonedzoo)
"bn" = (
/obj/structure/cable,
/obj/machinery/power/smes/engineering,
/turf/open/floor/iron/dark/side,
/area/ruin/space/has_grav/abandonedzoo)
"bp" = (
/obj/structure/disposalpipe/segment,
/obj/structure/reagent_dispensers/watertank,
/turf/open/floor/iron/dark/corner{
	dir = 8
	},
/area/ruin/space/has_grav/abandonedzoo)
"br" = (
/obj/structure/table/reinforced,
/obj/item/surgicaldrill,
/obj/item/hemostat,
/obj/item/scalpel,
/obj/item/surgical_drapes,
/obj/item/retractor,
/obj/item/cautery,
/obj/item/circular_saw,
/obj/item/reagent_containers/spray/cleaner,
/turf/open/floor/iron/dark/corner,
/area/ruin/space/has_grav/abandonedzoo)
"bs" = (
/obj/structure/cable,
/obj/machinery/power/shieldwallgen/anchored,
/turf/open/floor/plating,
/area/ruin/space/has_grav/abandonedzoo)
"bt" = (
/obj/structure/cable,
/obj/machinery/power/shieldwallgen/anchored,
/turf/open/floor/plating/airless,
/area/ruin/space/has_grav/abandonedzoo)
"bu" = (
/obj/structure/flora/ausbushes/sunnybush,
/turf/open/floor/plating,
/area/ruin/space/has_grav/abandonedzoo)
"bv" = (
/turf/open/floor/plating,
/area/ruin/space/has_grav/abandonedzoo)
"bx" = (
/obj/structure/flora/ausbushes/palebush,
/turf/open/floor/plating,
/area/ruin/space/has_grav/abandonedzoo)
"by" = (
/obj/machinery/space_heater,
/obj/machinery/light/directional/west,
/obj/structure/disposalpipe/segment,
/turf/open/floor/iron/dark/side{
	dir = 10
	},
/area/ruin/space/has_grav/abandonedzoo)
"bA" = (
/obj/structure/table/optable,
/turf/open/floor/iron/dark/side,
/area/ruin/space/has_grav/abandonedzoo)
"bB" = (
/obj/structure/alien/weeds,
/turf/open/floor/plating/airless,
/area/ruin/space/has_grav/abandonedzoo)
"bD" = (
/obj/item/clothing/mask/facehugger/dead,
/obj/structure/alien/weeds,
/turf/open/floor/plating/airless,
/area/ruin/space/has_grav/abandonedzoo)
"bE" = (
/obj/structure/flora/ausbushes/sparsegrass,
/turf/open/floor/plating,
/area/ruin/space/has_grav/abandonedzoo)
"bF" = (
/obj/structure/disposalpipe/segment,
/turf/closed/wall/r_wall,
/area/ruin/space/has_grav/abandonedzoo)
"bG" = (
/obj/machinery/door/airlock/external,
/obj/effect/mapping_helpers/airlock/cyclelink_helper,
/obj/effect/turf_decal/tile/green{
	dir = 1
	},
/obj/effect/turf_decal/tile/green,
/obj/effect/turf_decal/tile/green{
	dir = 4
	},
/obj/effect/turf_decal/tile/green{
	dir = 8
	},
/turf/open/floor/iron/dark,
/area/ruin/space/has_grav/abandonedzoo)
"bH" = (
/obj/structure/alien/resin/wall,
/turf/open/floor/plating/airless,
/area/ruin/space/has_grav/abandonedzoo)
"bI" = (
/obj/structure/flora/ausbushes/reedbush,
/turf/open/floor/plating,
/area/ruin/space/has_grav/abandonedzoo)
"bJ" = (
/mob/living/simple_animal/crab{
	faction = list("carp")
	},
/turf/open/floor/plating,
/area/ruin/space/has_grav/abandonedzoo)
"bK" = (
/obj/structure/disposalpipe/segment,
/turf/open/floor/plating/airless,
/area/template_noop)
"bN" = (
/obj/structure/grille/broken,
/obj/item/stack/cable_coil/cut,
/obj/item/shard{
	icon_state = "small"
	},
/turf/open/floor/plating/airless,
/area/ruin/space/has_grav/abandonedzoo)
"bO" = (
/obj/item/shard,
/turf/open/floor/plating/airless,
/area/ruin/space/has_grav/abandonedzoo)
"bP" = (
/obj/structure/lattice,
/turf/template_noop,
/area/template_noop)
"bQ" = (
/obj/machinery/computer/operating{
	dir = 8
	},
/obj/machinery/light/directional/south,
/turf/open/floor/iron/dark/side,
/area/ruin/space/has_grav/abandonedzoo)
"bR" = (
/obj/structure/disposalpipe/trunk{
	dir = 1
	},
/obj/structure/disposaloutlet,
/turf/open/floor/plating/airless,
/area/template_noop)
"bT" = (
/obj/structure/grille,
/obj/item/shard{
	icon_state = "medium"
	},
/turf/open/floor/plating/airless,
/area/ruin/space/has_grav/abandonedzoo)
"bU" = (
/obj/structure/grille/broken,
/turf/open/floor/plating/airless,
/area/ruin/space/has_grav/abandonedzoo)
"bV" = (
/obj/machinery/power/shieldwallgen,
/turf/template_noop,
/area/template_noop)
"bW" = (
/obj/item/shard,
/turf/template_noop,
/area/template_noop)
"bX" = (
/turf/open/floor/plating/airless,
/area/ruin/space/has_grav/abandonedzoo)
"gE" = (
/mob/living/simple_animal/hostile/bee,
/turf/open/floor/grass,
/area/ruin/space/has_grav/abandonedzoo)
"iZ" = (
/obj/machinery/light/small/directional/west,
/obj/item/stack/cable_coil/cut,
/obj/item/stack/tile/iron/base{
	pixel_x = 3;
	pixel_y = -4
	},
/obj/item/wirecutters,
/obj/structure/cable,
/obj/effect/turf_decal/tile/neutral,
/obj/effect/turf_decal/tile/neutral{
	dir = 4
	},
/obj/effect/turf_decal/tile/neutral{
	dir = 1
	},
/obj/effect/turf_decal/tile/neutral{
	dir = 8
	},
/turf/open/floor/plating,
/area/ruin/space/has_grav/abandonedzoo)
"kp" = (
/obj/machinery/light/small/directional/west,
/obj/structure/cable,
/obj/effect/turf_decal/tile/neutral,
/obj/effect/turf_decal/tile/neutral{
	dir = 4
	},
/obj/effect/turf_decal/tile/neutral{
	dir = 1
	},
/obj/effect/turf_decal/tile/neutral{
	dir = 8
	},
/turf/open/floor/iron/dark,
/area/ruin/space/has_grav/abandonedzoo)
"kF" = (
/obj/structure/disposalpipe/segment,
/obj/structure/closet/wardrobe/science_white,
/turf/open/floor/iron/dark/side{
	dir = 10
	},
/area/ruin/space/has_grav/abandonedzoo)
"lo" = (
/obj/machinery/door/airlock/external,
/obj/effect/mapping_helpers/airlock/cyclelink_helper{
	dir = 1
	},
/obj/effect/turf_decal/tile/green{
	dir = 1
	},
/obj/effect/turf_decal/tile/green,
/obj/effect/turf_decal/tile/green{
	dir = 4
	},
/obj/effect/turf_decal/tile/green{
	dir = 8
	},
/turf/open/floor/iron/dark,
/area/ruin/space/has_grav/abandonedzoo)
"mY" = (
/obj/structure/alien/weeds/node,
/obj/machinery/light/directional/north,
/turf/open/floor/plating/airless,
/area/ruin/space/has_grav/abandonedzoo)
"nY" = (
/obj/structure/flora/ausbushes/leafybush,
/mob/living/simple_animal/hostile/bee,
/turf/open/floor/grass,
/area/ruin/space/has_grav/abandonedzoo)
"rG" = (
/obj/machinery/light/small/directional/west,
/obj/effect/turf_decal/tile/green{
	dir = 1
	},
/obj/effect/turf_decal/tile/green,
/obj/effect/turf_decal/tile/green{
	dir = 4
	},
/obj/effect/turf_decal/tile/green{
	dir = 8
	},
/turf/open/floor/iron/dark,
/area/ruin/space/has_grav/abandonedzoo)
"uA" = (
/obj/structure/table/reinforced,
/obj/machinery/microwave,
/turf/open/floor/iron/dark/side{
	dir = 4
	},
/area/ruin/space/has_grav/abandonedzoo)
"vk" = (
/obj/structure/table/reinforced,
/obj/item/gun/energy/temperature{
	pin = /obj/item/firing_pin
	},
/turf/open/floor/iron/dark/side{
	dir = 1
	},
/area/ruin/space/has_grav/abandonedzoo)
"wc" = (
/obj/machinery/light/small/directional/east,
/obj/structure/cable,
/obj/effect/turf_decal/tile/neutral,
/obj/effect/turf_decal/tile/neutral{
	dir = 4
	},
/obj/effect/turf_decal/tile/neutral{
	dir = 1
	},
/obj/effect/turf_decal/tile/neutral{
	dir = 8
	},
/turf/open/floor/iron/dark,
/area/ruin/space/has_grav/abandonedzoo)
"wF" = (
/obj/machinery/door/airlock/hatch{
	name = "Bio-Research Station"
	},
/obj/effect/turf_decal/tile/green{
	dir = 1
	},
/obj/effect/turf_decal/tile/green,
/obj/effect/turf_decal/tile/green{
	dir = 4
	},
/obj/effect/turf_decal/tile/green{
	dir = 8
	},
/obj/structure/cable,
/turf/open/floor/iron/dark,
/area/ruin/space/has_grav/abandonedzoo)
"xi" = (
/obj/effect/turf_decal/tile/green{
	dir = 1
	},
/obj/effect/turf_decal/tile/green,
/obj/effect/turf_decal/tile/green{
	dir = 4
	},
/obj/effect/turf_decal/tile/green{
	dir = 8
	},
/obj/structure/cable,
/obj/effect/decal/cleanable/dirt/dust,
/turf/open/floor/iron/dark,
/area/ruin/space/has_grav/abandonedzoo)
"xW" = (
/obj/structure/flora/rock,
/obj/machinery/light/directional/south,
/turf/open/floor/plating/asteroid,
/area/ruin/space/has_grav/abandonedzoo)
"Ck" = (
/obj/effect/turf_decal/tile/green{
	dir = 1
	},
/obj/effect/turf_decal/tile/green,
/obj/effect/turf_decal/tile/green{
	dir = 4
	},
/obj/effect/turf_decal/tile/green{
	dir = 8
	},
/obj/structure/cable,
/turf/open/floor/iron/dark,
/area/ruin/space/has_grav/abandonedzoo)
"Ct" = (
/obj/structure/table/reinforced,
/obj/machinery/reagentgrinder,
/obj/machinery/light/directional/east,
/turf/open/floor/iron/dark/side{
	dir = 4
	},
/area/ruin/space/has_grav/abandonedzoo)
"Gp" = (
/obj/effect/turf_decal/tile/green{
	dir = 1
	},
/obj/effect/turf_decal/tile/green,
/obj/effect/turf_decal/tile/green{
	dir = 4
	},
/obj/effect/turf_decal/tile/green{
	dir = 8
	},
/obj/structure/closet/wardrobe/science_white,
/turf/open/floor/iron/dark,
/area/ruin/space/has_grav/abandonedzoo)
"GX" = (
/obj/effect/turf_decal/tile/green{
	dir = 1
	},
/obj/effect/turf_decal/tile/green,
/obj/effect/turf_decal/tile/green{
	dir = 4
	},
/obj/effect/turf_decal/tile/green{
	dir = 8
	},
/obj/structure/cable,
/obj/machinery/disposal/bin,
/obj/structure/disposalpipe/trunk,
/turf/open/floor/iron/dark,
/area/ruin/space/has_grav/abandonedzoo)
"Ig" = (
/obj/machinery/light/directional/north,
/mob/living/simple_animal/hostile/carp,
/turf/open/floor/plating,
/area/ruin/space/has_grav/abandonedzoo)
"Mb" = (
/mob/living/simple_animal/hostile/bee,
/mob/living/simple_animal/hostile/bee,
/mob/living/simple_animal/hostile/bee,
/mob/living/simple_animal/hostile/bee,
/mob/living/simple_animal/hostile/bee,
/mob/living/simple_animal/hostile/bee,
/turf/open/floor/grass,
/area/ruin/space/has_grav/abandonedzoo)
"Ng" = (
/obj/structure/alien/weeds,
/obj/structure/alien/weeds/node,
/turf/open/floor/plating/airless,
/area/ruin/space/has_grav/abandonedzoo)
"OR" = (
/obj/structure/cable,
/obj/structure/frame/machine,
/turf/open/floor/plating/airless,
/area/ruin/space/has_grav/abandonedzoo)
"Po" = (
/obj/machinery/light/small/directional/east,
/obj/effect/turf_decal/tile/green{
	dir = 1
	},
/obj/effect/turf_decal/tile/green,
/obj/effect/turf_decal/tile/green{
	dir = 4
	},
/obj/effect/turf_decal/tile/green{
	dir = 8
	},
/turf/open/floor/iron/dark,
/area/ruin/space/has_grav/abandonedzoo)
"PF" = (
/obj/machinery/light/directional/south,
/mob/living/simple_animal/hostile/bee,
/mob/living/simple_animal/hostile/bee,
/turf/open/floor/grass,
/area/ruin/space/has_grav/abandonedzoo)
"PS" = (
/obj/effect/turf_decal/tile/green{
	dir = 1
	},
/obj/effect/turf_decal/tile/green,
/obj/effect/turf_decal/tile/green{
	dir = 4
	},
/obj/effect/turf_decal/tile/green{
	dir = 8
	},
/obj/structure/chair/office/light{
	dir = 8
	},
/turf/open/floor/iron/dark,
/area/ruin/space/has_grav/abandonedzoo)

(1,1,1) = {"
ab
ac
ac
ac
ac
ab
aa
aa
aa
aa
aa
aa
ab
ac
ac
ac
ac
ab
aa
"}
(2,1,1) = {"
ac
ah
ai
ar
ah
ac
aK
aK
aK
aK
aK
aK
ac
bu
bv
bI
bv
ac
aa
"}
(3,1,1) = {"
ac
ah
ap
ai
ai
aD
aL
wc
aL
aL
wc
aL
aD
bv
bv
bJ
bv
ac
aa
"}
(4,1,1) = {"
ac
ai
ah
ai
xW
ac
at
at
bb
wF
at
at
ac
Ig
bv
bv
bv
ac
aa
"}
(5,1,1) = {"
ac
aj
ai
as
ar
ac
aW
aO
Ck
Ck
Ck
bm
ac
bx
bE
bv
bv
ac
aa
"}
(6,1,1) = {"
ab
ac
ac
ac
ac
aP
aY
ay
ay
aO
bf
bn
aE
ac
ac
ac
ac
OR
aa
"}
(7,1,1) = {"
aa
aa
aa
at
aG
aS
aZ
aV
ay
Ck
GX
bp
kF
by
bF
bK
bK
bR
aa
"}
(8,1,1) = {"
aa
aa
aa
ag
ay
ay
PS
aV
aO
xi
aO
ay
ay
Gp
at
at
at
aa
aa
"}
(9,1,1) = {"
aa
aa
aa
ag
aI
ay
ay
aO
bh
bk
ay
ay
ay
ay
bG
rG
lo
aa
aa
"}
(10,1,1) = {"
aa
aa
aa
ag
ay
aO
aO
aO
bi
bl
ay
ay
aO
aO
bG
Po
lo
aa
aa
"}
(11,1,1) = {"
aa
aa
aa
ag
ay
aO
ay
ay
ay
Ck
ay
ay
ay
ay
at
at
at
aa
aa
"}
(12,1,1) = {"
aa
aa
aa
at
aN
aT
bd
ay
ay
xi
ay
br
uA
Ct
at
aa
aa
aa
aa
"}
(13,1,1) = {"
ab
ac
ac
ac
ac
aE
vk
ay
aO
xi
ay
bA
bs
ac
ac
ac
ac
bt
aa
"}
(14,1,1) = {"
ac
al
gE
gE
aA
ac
be
ay
ay
Ck
ay
bQ
ac
bB
Ng
bD
bH
ac
aa
"}
(15,1,1) = {"
ac
Mb
Mb
ao
PF
ac
at
at
bb
wF
at
at
ac
mY
bH
bH
bB
bT
aa
"}
(16,1,1) = {"
ac
gE
aq
nY
Mb
aD
aL
kp
aL
aL
iZ
aL
aD
bD
bB
Ng
bO
bU
bW
"}
(17,1,1) = {"
ac
ao
gE
av
aC
ac
aQ
aQ
aQ
aQ
aQ
aQ
ac
bB
bB
bB
bX
bP
aa
"}
(18,1,1) = {"
ab
ac
ac
ac
ac
ab
aa
aa
aa
aa
aa
aa
bt
ac
ac
bN
bP
aa
aa
"}
(19,1,1) = {"
aa
aa
aa
aa
aa
aa
aa
aa
aa
aa
aa
aa
aa
aa
aa
aa
aa
bV
aa
"}
