//MAP CONVERTED BY dmm2tgm.py THIS HEADER COMMENT PREVENTS RECONVERSION, DO NOT REMOVE
"aa" = (
/turf/template_noop,
/area/template_noop)
"ab" = (
/obj/machinery/power/shieldwallgen/anchored,
/obj/structure/cable,
/turf/open/floor/plating/airless,
/area/ruin/space/has_grav/abandonedzoo)
"ac" = (
/obj/effect/spawner/structure/window/reinforced,
/obj/structure/cable,
/turf/open/floor/plating,
/area/ruin/space/has_grav/abandonedzoo)
"ag" = (
/obj/effect/spawner/structure/window/reinforced,
/turf/open/floor/plating,
/area/ruin/space/has_grav/abandonedzoo)
"ah" = (
/turf/open/floor/plating/asteroid/basalt/lava_land_surface,
/area/ruin/space/has_grav/abandonedzoo)
"ai" = (
/mob/living/simple_animal/hostile/planet/shantak/lava,
/turf/open/floor/plating/asteroid/basalt/lava_land_surface,
/area/ruin/space/has_grav/abandonedzoo)
"aj" = (
/obj/structure/flora/rock,
/turf/open/floor/plating/asteroid/basalt/lava_land_surface,
/area/ruin/space/has_grav/abandonedzoo)
"ak" = (
/obj/effect/turf_decal/tile/green{
	dir = 8
	},
/obj/effect/turf_decal/tile/green{
	dir = 1
	},
/obj/effect/turf_decal/tile/green{
	dir = 4
	},
/obj/effect/turf_decal/tile/green,
/obj/item/food/pizzaslice/moldy,
/obj/effect/decal/cleanable/dirt/dust{
	layer = 2.032
	},
/turf/open/floor/iron/dark,
/area/ruin/space/has_grav/abandonedzoo)
"al" = (
/obj/structure/flora/ausbushes/genericbush,
/turf/open/floor/grass,
/area/ruin/space/has_grav/abandonedzoo)
"ao" = (
/obj/structure/flora/ausbushes/lavendergrass,
/turf/open/floor/grass,
/area/ruin/space/has_grav/abandonedzoo)
"ap" = (
/mob/living/simple_animal/hostile/asteroid/goldgrub{
	will_burrow = 0
	},
/turf/open/floor/plating/asteroid/basalt/lava_land_surface,
/area/ruin/space/has_grav/abandonedzoo)
"aq" = (
/obj/structure/flora/ausbushes/grassybush,
/turf/open/floor/grass,
/area/ruin/space/has_grav/abandonedzoo)
"ar" = (
/obj/structure/flora/rock/pile,
/turf/open/floor/plating/asteroid/basalt/lava_land_surface,
/area/ruin/space/has_grav/abandonedzoo)
"at" = (
/turf/closed/wall/r_wall,
/area/ruin/space/has_grav/abandonedzoo)
"av" = (
/obj/structure/flora/ausbushes/brflowers,
/turf/open/floor/grass,
/area/ruin/space/has_grav/abandonedzoo)
"ay" = (
/obj/effect/turf_decal/tile/green{
	dir = 1
	},
/obj/effect/turf_decal/tile/green,
/obj/effect/turf_decal/tile/green{
	dir = 4
	},
/obj/effect/turf_decal/tile/green{
	dir = 8
	},
/obj/effect/decal/cleanable/dirt/dust{
	layer = 2.032
	},
/obj/effect/decal/cleanable/dirt/dust{
	layer = 2.032
	},
/obj/structure/cable,
/turf/open/floor/iron/dark,
/area/ruin/space/has_grav/abandonedzoo)
"aA" = (
/obj/structure/flora/ausbushes/ywflowers,
/turf/open/floor/grass,
/area/ruin/space/has_grav/abandonedzoo)
"aC" = (
/obj/structure/flora/ausbushes/ppflowers,
/turf/open/floor/grass,
/area/ruin/space/has_grav/abandonedzoo)
"aD" = (
/obj/machinery/door/airlock/highsecurity{
	name = "Bio Containment";
	req_one_access_txt = "47"
	},
/obj/structure/cable,
/obj/effect/turf_decal/tile/neutral,
/obj/effect/turf_decal/tile/neutral{
	dir = 4
	},
/obj/effect/turf_decal/tile/neutral{
	dir = 1
	},
/obj/effect/turf_decal/tile/neutral{
	dir = 8
	},
/obj/effect/decal/cleanable/dirt/dust{
	layer = 2.032
	},
/turf/open/floor/iron/dark,
/area/ruin/space/has_grav/abandonedzoo)
"aE" = (
/obj/machinery/power/shieldwallgen/anchored,
/obj/structure/cable,
/obj/effect/decal/cleanable/dirt/dust{
	layer = 2.032
	},
/obj/effect/decal/cleanable/dirt/dust{
	layer = 2.032
	},
/turf/open/floor/plating,
/area/ruin/space/has_grav/abandonedzoo)
"aG" = (
/obj/structure/table/reinforced,
/obj/machinery/microwave,
/obj/machinery/light/directional/north,
/obj/effect/decal/cleanable/dirt/dust{
	layer = 2.032
	},
/obj/effect/decal/cleanable/dirt/dust{
	layer = 2.032
	},
/turf/open/floor/iron/dark/side{
	dir = 10
	},
/area/ruin/space/has_grav/abandonedzoo)
"aK" = (
/obj/structure/window/reinforced{
	dir = 4
	},
/turf/template_noop,
/area/template_noop)
"aL" = (
/obj/structure/cable,
/obj/effect/turf_decal/tile/neutral,
/obj/effect/turf_decal/tile/neutral{
	dir = 4
	},
/obj/effect/turf_decal/tile/neutral{
	dir = 1
	},
/obj/effect/turf_decal/tile/neutral{
	dir = 8
	},
/obj/effect/decal/cleanable/dirt/dust{
	layer = 2.032
	},
/turf/open/floor/iron/dark,
/area/ruin/space/has_grav/abandonedzoo)
"aN" = (
/obj/structure/guncase,
/obj/item/gun/energy/floragun,
/obj/item/gun/syringe,
/obj/item/gun/energy/temperature{
	pin = /obj/item/firing_pin
	},
/obj/machinery/light/directional/north,
/obj/effect/decal/cleanable/dirt/dust{
	layer = 2.032
	},
/obj/effect/decal/cleanable/dirt/dust{
	layer = 2.032
	},
/obj/effect/decal/cleanable/dirt/dust{
	layer = 2.032
	},
/turf/open/floor/iron/dark/side{
	dir = 4
	},
/area/ruin/space/has_grav/abandonedzoo)
"aO" = (
/obj/effect/turf_decal/tile/green{
	dir = 1
	},
/obj/effect/turf_decal/tile/green,
/obj/effect/turf_decal/tile/green{
	dir = 4
	},
/obj/effect/turf_decal/tile/green{
	dir = 8
	},
/obj/effect/decal/cleanable/dirt/dust{
	layer = 2.032
	},
/obj/effect/decal/cleanable/dirt/dust{
	layer = 2.032
	},
/turf/open/floor/iron/dark,
/area/ruin/space/has_grav/abandonedzoo)
"aP" = (
/obj/structure/cable,
/obj/structure/frame/machine,
/obj/effect/decal/cleanable/dirt/dust{
	layer = 2.032
	},
/turf/open/floor/plating,
/area/ruin/space/has_grav/abandonedzoo)
"aQ" = (
/obj/structure/window/reinforced{
	dir = 8
	},
/turf/template_noop,
/area/template_noop)
"aS" = (
/obj/structure/table/reinforced,
/obj/item/food/carrotfries,
/obj/item/food/carrotfries,
/obj/item/food/carrotfries,
/obj/item/food/carrotfries,
/obj/effect/decal/cleanable/dirt/dust{
	layer = 2.032
	},
/obj/effect/decal/cleanable/dirt/dust{
	layer = 2.032
	},
/turf/open/floor/iron/dark/side{
	dir = 10
	},
/area/ruin/space/has_grav/abandonedzoo)
"aT" = (
/obj/structure/table/reinforced,
/obj/item/grenade/chem_grenade/antiweed{
	pixel_x = -3;
	pixel_y = -1
	},
/obj/item/grenade/chem_grenade/antiweed{
	pixel_x = 3;
	pixel_y = 5
	},
/obj/item/grenade/chem_grenade/antiweed{
	pixel_x = 4
	},
/obj/effect/decal/cleanable/dirt/dust{
	layer = 2.032
	},
/obj/effect/decal/cleanable/dirt/dust{
	layer = 2.032
	},
/obj/effect/decal/cleanable/dirt/dust{
	layer = 2.032
	},
/turf/open/floor/iron/dark/side{
	dir = 4
	},
/area/ruin/space/has_grav/abandonedzoo)
"aV" = (
/obj/effect/turf_decal/tile/green{
	dir = 8
	},
/obj/effect/turf_decal/tile/green{
	dir = 1
	},
/obj/effect/turf_decal/tile/green{
	dir = 4
	},
/obj/effect/turf_decal/tile/green,
/obj/effect/decal/cleanable/dirt/dust{
	layer = 2.032
	},
/turf/open/floor/iron/dark,
/area/ruin/space/has_grav/abandonedzoo)
"aW" = (
/obj/structure/rack,
/obj/item/melee/baton/cattleprod,
/obj/effect/spawner/lootdrop/maintenance,
/obj/effect/spawner/lootdrop,
/obj/machinery/light/directional/north,
/obj/machinery/light/directional/west,
/obj/effect/decal/cleanable/dirt/dust{
	layer = 2.032
	},
/obj/item/wrench/medical,
/turf/open/floor/iron/dark/side{
	dir = 1
	},
/area/ruin/space/has_grav/abandonedzoo)
"aY" = (
/obj/item/tank/internals/emergency_oxygen/double,
/obj/item/clothing/suit/space/hardsuit/medical,
/obj/structure/closet/crate/internals,
/obj/effect/decal/cleanable/dirt/dust{
	layer = 2.032
	},
/turf/open/floor/iron/dark/side{
	dir = 1
	},
/area/ruin/space/has_grav/abandonedzoo)
"aZ" = (
/obj/structure/table/reinforced,
/obj/item/food/pizzaslice/moldy,
/obj/item/food/pizzaslice/moldy,
/obj/item/food/pizzaslice/moldy,
/obj/item/food/pizzaslice/moldy,
/obj/effect/decal/cleanable/dirt/dust{
	layer = 2.032
	},
/obj/effect/decal/cleanable/dirt/dust{
	layer = 2.032
	},
/turf/open/floor/iron/dark/corner{
	dir = 1
	},
/area/ruin/space/has_grav/abandonedzoo)
"bb" = (
/obj/machinery/door/airlock/hatch{
	name = "Bio-Research Station";
	dir = 4
	},
/obj/effect/turf_decal/tile/green{
	dir = 1
	},
/obj/effect/turf_decal/tile/green,
/obj/effect/turf_decal/tile/green{
	dir = 4
	},
/obj/effect/turf_decal/tile/green{
	dir = 8
	},
/obj/effect/decal/cleanable/dirt/dust{
	layer = 2.032
	},
/turf/open/floor/iron/dark,
/area/ruin/space/has_grav/abandonedzoo)
"bd" = (
/obj/structure/table/reinforced,
/obj/effect/decal/cleanable/dirt/dust{
	layer = 2.032
	},
/obj/item/shovel,
/obj/item/cultivator,
/turf/open/floor/iron/dark/corner{
	dir = 4
	},
/area/ruin/space/has_grav/abandonedzoo)
"be" = (
/obj/machinery/light/directional/north,
/obj/structure/closet/wardrobe/science_white,
/obj/machinery/light/directional/east,
/obj/effect/decal/cleanable/dirt/dust{
	layer = 2.032
	},
/obj/effect/decal/cleanable/dirt/dust{
	layer = 2.032
	},
/turf/open/floor/iron/dark/side{
	dir = 1
	},
/area/ruin/space/has_grav/abandonedzoo)
"bf" = (
/obj/effect/turf_decal/tile/green{
	dir = 1
	},
/obj/effect/turf_decal/tile/green,
/obj/effect/turf_decal/tile/green{
	dir = 4
	},
/obj/effect/turf_decal/tile/green{
	dir = 8
	},
/obj/effect/decal/cleanable/dirt/dust{
	layer = 2.032
	},
/obj/structure/cable,
/turf/open/floor/iron/dark,
/area/ruin/space/has_grav/abandonedzoo)
"bh" = (
/obj/structure/table/reinforced,
/obj/item/gps/spaceruin,
/obj/effect/turf_decal/tile/green{
	dir = 8
	},
/obj/effect/turf_decal/tile/green,
/obj/effect/turf_decal/tile/green{
	dir = 4
	},
/obj/effect/turf_decal/tile/green{
	dir = 1
	},
/obj/effect/decal/cleanable/dirt/dust{
	layer = 2.032
	},
/obj/effect/decal/cleanable/dirt/dust{
	layer = 2.032
	},
/obj/effect/decal/cleanable/dirt/dust{
	layer = 2.032
	},
/turf/open/floor/iron/dark,
/area/ruin/space/has_grav/abandonedzoo)
"bi" = (
/obj/structure/table/reinforced,
/obj/effect/turf_decal/tile/green{
	dir = 8
	},
/obj/effect/turf_decal/tile/green,
/obj/effect/turf_decal/tile/green{
	dir = 4
	},
/obj/effect/turf_decal/tile/green{
	dir = 1
	},
/obj/effect/decal/cleanable/dirt/dust{
	layer = 2.032
	},
/obj/effect/decal/cleanable/dirt/dust{
	layer = 2.032
	},
/obj/item/clipboard,
/obj/item/folder,
/turf/open/floor/iron/dark,
/area/ruin/space/has_grav/abandonedzoo)
"bk" = (
/obj/effect/turf_decal/tile/green{
	dir = 1
	},
/obj/effect/turf_decal/tile/green,
/obj/effect/turf_decal/tile/green{
	dir = 4
	},
/obj/effect/turf_decal/tile/green{
	dir = 8
	},
/obj/structure/table/reinforced,
/obj/effect/decal/cleanable/dirt/dust{
	layer = 2.032
	},
/obj/effect/decal/cleanable/dirt/dust{
	layer = 2.032
	},
/obj/item/reagent_containers/glass/bottle/random_virus,
/obj/item/reagent_containers/dropper,
/turf/open/floor/iron/dark,
/area/ruin/space/has_grav/abandonedzoo)
"bl" = (
/obj/effect/turf_decal/tile/green{
	dir = 1
	},
/obj/effect/turf_decal/tile/green,
/obj/effect/turf_decal/tile/green{
	dir = 4
	},
/obj/effect/turf_decal/tile/green{
	dir = 8
	},
/obj/structure/table/reinforced,
/obj/item/reagent_containers/glass/bottle/mutagen,
/obj/item/reagent_containers/hypospray/medipen/stimpack,
/obj/effect/decal/cleanable/dirt/dust{
	layer = 2.032
	},
/obj/effect/decal/cleanable/dirt/dust{
	layer = 2.032
	},
/turf/open/floor/iron/dark,
/area/ruin/space/has_grav/abandonedzoo)
"bm" = (
/obj/structure/reagent_dispensers/fueltank,
/obj/machinery/light/directional/south,
/obj/machinery/light/directional/west,
/obj/effect/decal/cleanable/dirt/dust{
	layer = 2.032
	},
/obj/effect/decal/cleanable/dirt/dust{
	layer = 2.032
	},
/turf/open/floor/iron/dark/side,
/area/ruin/space/has_grav/abandonedzoo)
"bn" = (
/obj/structure/reagent_dispensers/watertank,
/obj/effect/decal/cleanable/dirt/dust{
	layer = 2.032
	},
/obj/effect/decal/cleanable/dirt/dust{
	layer = 2.032
	},
/turf/open/floor/iron/dark/side,
/area/ruin/space/has_grav/abandonedzoo)
"bp" = (
/obj/machinery/power/smes/engineering,
/obj/structure/cable,
/obj/effect/decal/cleanable/dirt/dust{
	layer = 2.032
	},
/turf/open/floor/iron/dark/corner{
	dir = 8
	},
/area/ruin/space/has_grav/abandonedzoo)
"br" = (
/obj/structure/table/reinforced,
/obj/item/storage/backpack/duffelbag/med/surgery,
/obj/item/clothing/mask/surgical,
/obj/effect/decal/cleanable/dirt/dust{
	layer = 2.032
	},
/turf/open/floor/iron/dark/corner,
/area/ruin/space/has_grav/abandonedzoo)
"bs" = (
/obj/structure/cable,
/obj/machinery/power/shieldwallgen/anchored,
/obj/effect/decal/cleanable/dirt/dust{
	layer = 2.032
	},
/obj/effect/decal/cleanable/dirt/dust{
	layer = 2.032
	},
/turf/open/floor/plating,
/area/ruin/space/has_grav/abandonedzoo)
"bt" = (
/obj/structure/cable,
/obj/machinery/power/shieldwallgen/anchored,
/turf/open/floor/plating/airless,
/area/ruin/space/has_grav/abandonedzoo)
"bu" = (
/turf/open/floor/plating/beach/sand,
/area/ruin/space/has_grav/abandonedzoo)
"bv" = (
/turf/open/floor/plating/beach/coastline_b,
/area/ruin/space/has_grav/abandonedzoo)
"bx" = (
/obj/structure/flora/tree/palm,
/turf/open/floor/plating/beach/sand,
/area/ruin/space/has_grav/abandonedzoo)
"by" = (
/obj/machinery/space_heater,
/obj/structure/disposalpipe/segment,
/obj/machinery/light/directional/south,
/obj/effect/decal/cleanable/dirt/dust{
	layer = 2.032
	},
/obj/effect/decal/cleanable/dirt/dust{
	layer = 2.032
	},
/turf/open/floor/iron/dark/side{
	dir = 10
	},
/area/ruin/space/has_grav/abandonedzoo)
"bA" = (
/obj/structure/table/optable,
/obj/effect/decal/cleanable/dirt/dust{
	layer = 2.032
	},
/obj/effect/decal/cleanable/dirt/dust{
	layer = 2.032
	},
/turf/open/floor/iron/dark/side,
/area/ruin/space/has_grav/abandonedzoo)
"bB" = (
/obj/structure/alien/weeds,
/turf/open/floor/plating/airless,
/area/ruin/space/has_grav/abandonedzoo)
"bD" = (
/obj/item/clothing/mask/facehugger/dead,
/obj/structure/alien/weeds,
/turf/open/floor/plating/airless,
/area/ruin/space/has_grav/abandonedzoo)
"bE" = (
/obj/structure/flora/ausbushes/sparsegrass,
/turf/open/floor/plating/beach/coastline_t/sandwater_inner{
	dir = 8
	},
/area/ruin/space/has_grav/abandonedzoo)
"bF" = (
/obj/structure/disposalpipe/segment,
/turf/closed/wall/r_wall,
/area/ruin/space/has_grav/abandonedzoo)
"bG" = (
/obj/machinery/door/airlock/external,
/obj/effect/mapping_helpers/airlock/cyclelink_helper,
/obj/effect/turf_decal/tile/green{
	dir = 1
	},
/obj/effect/turf_decal/tile/green,
/obj/effect/turf_decal/tile/green{
	dir = 4
	},
/obj/effect/turf_decal/tile/green{
	dir = 8
	},
/obj/effect/decal/cleanable/dirt/dust{
	layer = 2.032
	},
/turf/open/floor/iron/dark,
/area/ruin/space/has_grav/abandonedzoo)
"bH" = (
/obj/structure/alien/weeds,
/obj/structure/alien/resin/wall,
/turf/open/floor/plating/airless,
/area/ruin/space/has_grav/abandonedzoo)
"bI" = (
/obj/structure/flora/ausbushes/reedbush,
/turf/open/floor/plating/beach/coastline_t{
	dir = 6
	},
/area/ruin/space/has_grav/abandonedzoo)
"bJ" = (
/turf/open/floor/plating/beach/coastline_b{
	dir = 9
	},
/area/ruin/space/has_grav/abandonedzoo)
"bK" = (
/obj/structure/disposalpipe/segment,
/obj/structure/lattice,
/turf/template_noop,
/area/template_noop)
"bN" = (
/obj/structure/grille/broken,
/obj/item/stack/cable_coil/cut,
/obj/item/shard{
	icon_state = "small"
	},
/turf/open/floor/plating/airless,
/area/ruin/space/has_grav/abandonedzoo)
"bO" = (
/obj/item/shard,
/obj/effect/decal/cleanable/dirt/dust{
	layer = 2.032
	},
/turf/open/floor/plating/airless,
/area/ruin/space/has_grav/abandonedzoo)
"bP" = (
/obj/structure/lattice,
/turf/template_noop,
/area/template_noop)
"bQ" = (
/obj/machinery/computer/operating{
	dir = 1
	},
/obj/machinery/light/directional/south,
/obj/machinery/light/directional/east,
/obj/effect/decal/cleanable/dirt/dust{
	layer = 2.032
	},
/obj/effect/decal/cleanable/dirt/dust{
	layer = 2.032
	},
/turf/open/floor/iron/dark/side,
/area/ruin/space/has_grav/abandonedzoo)
"bR" = (
/obj/structure/disposalpipe/trunk{
	dir = 1
	},
/obj/structure/disposaloutlet,
/turf/open/floor/plating/airless,
/area/template_noop)
"bT" = (
/obj/structure/grille,
/obj/item/shard{
	icon_state = "medium"
	},
/turf/open/floor/plating/airless,
/area/ruin/space/has_grav/abandonedzoo)
"bU" = (
/obj/structure/grille/broken,
/turf/open/floor/plating/airless,
/area/ruin/space/has_grav/abandonedzoo)
"bV" = (
/obj/machinery/power/shieldwallgen,
/turf/template_noop,
/area/template_noop)
"bW" = (
/obj/item/shard,
/turf/template_noop,
/area/template_noop)
"bX" = (
/obj/effect/decal/cleanable/dirt/dust{
	layer = 2.032
	},
/obj/effect/decal/cleanable/dirt/dust{
	layer = 2.032
	},
/turf/open/floor/plating/airless,
/area/ruin/space/has_grav/abandonedzoo)
"da" = (
/obj/effect/turf_decal/tile/green{
	dir = 1
	},
/obj/effect/turf_decal/tile/green,
/obj/effect/turf_decal/tile/green{
	dir = 4
	},
/obj/effect/turf_decal/tile/green{
	dir = 8
	},
/obj/structure/table/reinforced,
/obj/machinery/computer/med_data/laptop{
	pixel_y = 1
	},
/obj/effect/decal/cleanable/dirt/dust{
	layer = 2.032
	},
/obj/effect/decal/cleanable/dirt/dust{
	layer = 2.032
	},
/turf/open/floor/iron/dark,
/area/ruin/space/has_grav/abandonedzoo)
"dj" = (
/turf/open/floor/plating/beach/coastline_b{
	dir = 8
	},
/area/ruin/space/has_grav/abandonedzoo)
"dV" = (
/mob/living/simple_animal/hostile/bee,
/obj/structure/flora/ausbushes/sunnybush,
/turf/open/floor/grass,
/area/ruin/space/has_grav/abandonedzoo)
"fD" = (
/turf/open/floor/plating/beach/coastline_t,
/area/ruin/space/has_grav/abandonedzoo)
"fQ" = (
/obj/effect/turf_decal/tile/green{
	dir = 1
	},
/obj/effect/turf_decal/tile/green,
/obj/effect/turf_decal/tile/green{
	dir = 4
	},
/obj/effect/turf_decal/tile/green{
	dir = 8
	},
/obj/structure/cable,
/obj/effect/decal/cleanable/dirt/dust{
	layer = 2.032
	},
/turf/open/floor/iron/dark,
/area/ruin/space/has_grav/abandonedzoo)
"gE" = (
/mob/living/simple_animal/hostile/bee,
/turf/open/floor/grass,
/area/ruin/space/has_grav/abandonedzoo)
"iZ" = (
/obj/machinery/light/small/directional/west,
/obj/item/stack/cable_coil/cut,
/obj/item/stack/tile/iron/base{
	pixel_x = 3;
	pixel_y = -4
	},
/obj/item/wirecutters,
/obj/structure/cable,
/obj/effect/turf_decal/tile/neutral,
/obj/effect/turf_decal/tile/neutral{
	dir = 4
	},
/obj/effect/turf_decal/tile/neutral{
	dir = 1
	},
/obj/effect/turf_decal/tile/neutral{
	dir = 8
	},
/obj/effect/decal/cleanable/dirt/dust{
	layer = 2.032
	},
/turf/open/floor/plating,
/area/ruin/space/has_grav/abandonedzoo)
"ke" = (
/mob/living/simple_animal/crab{
	faction = list("carp")
	},
/obj/effect/overlay/palmtree_l,
/turf/open/floor/plating/beach/coastline_t/sandwater_inner,
/area/ruin/space/has_grav/abandonedzoo)
"kp" = (
/obj/machinery/light/small/directional/west,
/obj/structure/cable,
/obj/effect/turf_decal/tile/neutral,
/obj/effect/turf_decal/tile/neutral{
	dir = 4
	},
/obj/effect/turf_decal/tile/neutral{
	dir = 1
	},
/obj/effect/turf_decal/tile/neutral{
	dir = 8
	},
/obj/effect/decal/cleanable/dirt/dust{
	layer = 2.032
	},
/turf/open/floor/iron/dark,
/area/ruin/space/has_grav/abandonedzoo)
"kF" = (
/obj/machinery/disposal/bin,
/obj/structure/disposalpipe/trunk,
/obj/effect/decal/cleanable/dirt/dust{
	layer = 2.032
	},
/obj/effect/decal/cleanable/dirt/dust{
	layer = 2.032
	},
/turf/open/floor/iron/dark/side{
	dir = 10
	},
/area/ruin/space/has_grav/abandonedzoo)
"lo" = (
/obj/machinery/door/airlock/external,
/obj/effect/mapping_helpers/airlock/cyclelink_helper{
	dir = 1
	},
/obj/effect/turf_decal/tile/green{
	dir = 1
	},
/obj/effect/turf_decal/tile/green,
/obj/effect/turf_decal/tile/green{
	dir = 4
	},
/obj/effect/turf_decal/tile/green{
	dir = 8
	},
/obj/effect/decal/cleanable/dirt/dust{
	layer = 2.032
	},
/turf/open/floor/iron/dark,
/area/ruin/space/has_grav/abandonedzoo)
"mY" = (
/obj/structure/alien/weeds/node,
/obj/machinery/light/directional/north,
/turf/open/floor/plating/airless,
/area/ruin/space/has_grav/abandonedzoo)
"nY" = (
/obj/structure/flora/ausbushes/leafybush,
/mob/living/simple_animal/hostile/bee,
/turf/open/floor/grass,
/area/ruin/space/has_grav/abandonedzoo)
"ok" = (
/obj/structure/alien/weeds,
/mob/living/carbon/alien/larva,
/turf/open/floor/plating/airless,
/area/ruin/space/has_grav/abandonedzoo)
"qt" = (
/obj/effect/turf_decal/tile/green{
	dir = 1
	},
/obj/effect/turf_decal/tile/green,
/obj/effect/turf_decal/tile/green{
	dir = 4
	},
/obj/effect/turf_decal/tile/green{
	dir = 8
	},
/obj/effect/decal/cleanable/dirt/dust{
	layer = 2.032
	},
/obj/effect/mob_spawn/human/scientist,
/turf/open/floor/iron/dark,
/area/ruin/space/has_grav/abandonedzoo)
"rG" = (
/obj/machinery/light/small/directional/west,
/obj/effect/turf_decal/tile/green{
	dir = 1
	},
/obj/effect/turf_decal/tile/green,
/obj/effect/turf_decal/tile/green{
	dir = 4
	},
/obj/effect/turf_decal/tile/green{
	dir = 8
	},
/obj/effect/decal/cleanable/dirt/dust{
	layer = 2.032
	},
/turf/open/floor/iron/dark,
/area/ruin/space/has_grav/abandonedzoo)
"uA" = (
/obj/structure/table/reinforced,
/obj/effect/decal/cleanable/dirt/dust{
	layer = 2.032
	},
/obj/effect/decal/cleanable/dirt/dust{
	layer = 2.032
	},
/obj/item/tank/internals/anesthetic,
/obj/item/razor,
/obj/item/reagent_containers/spray/cleaner,
/turf/open/floor/iron/dark/side{
	dir = 4
	},
/area/ruin/space/has_grav/abandonedzoo)
"vk" = (
/obj/structure/closet/wardrobe/science_white,
/obj/effect/decal/cleanable/dirt/dust{
	layer = 2.032
	},
/turf/open/floor/iron/dark/side{
	dir = 1
	},
/area/ruin/space/has_grav/abandonedzoo)
"wc" = (
/obj/machinery/light/small/directional/east,
/obj/structure/cable,
/obj/effect/turf_decal/tile/neutral,
/obj/effect/turf_decal/tile/neutral{
	dir = 4
	},
/obj/effect/turf_decal/tile/neutral{
	dir = 1
	},
/obj/effect/turf_decal/tile/neutral{
	dir = 8
	},
/obj/effect/decal/cleanable/dirt/dust{
	layer = 2.032
	},
/turf/open/floor/iron/dark,
/area/ruin/space/has_grav/abandonedzoo)
"wF" = (
/obj/machinery/door/airlock/hatch{
	name = "Bio-Research Station";
	dir = 4
	},
/obj/effect/turf_decal/tile/green{
	dir = 1
	},
/obj/effect/turf_decal/tile/green,
/obj/effect/turf_decal/tile/green{
	dir = 4
	},
/obj/effect/turf_decal/tile/green{
	dir = 8
	},
/obj/structure/cable,
/obj/effect/decal/cleanable/dirt/dust{
	layer = 2.032
	},
/turf/open/floor/iron/dark,
/area/ruin/space/has_grav/abandonedzoo)
"xi" = (
/obj/effect/turf_decal/tile/green{
	dir = 1
	},
/obj/effect/turf_decal/tile/green,
/obj/effect/turf_decal/tile/green{
	dir = 4
	},
/obj/effect/turf_decal/tile/green{
	dir = 8
	},
/obj/effect/decal/cleanable/dirt/dust{
	layer = 2.032
	},
/obj/effect/decal/cleanable/dirt/dust{
	layer = 2.032
	},
/obj/effect/decal/cleanable/dirt/dust{
	layer = 2.032
	},
/obj/machinery/smartfridge/chemistry/virology,
/turf/open/floor/iron/dark,
/area/ruin/space/has_grav/abandonedzoo)
"xW" = (
/obj/structure/flora/rock,
/obj/machinery/light/directional/south,
/turf/open/floor/plating/asteroid/basalt/lava_land_surface,
/area/ruin/space/has_grav/abandonedzoo)
"AE" = (
/obj/effect/turf_decal/tile/green{
	dir = 1
	},
/obj/effect/turf_decal/tile/green,
/obj/effect/turf_decal/tile/green{
	dir = 4
	},
/obj/effect/turf_decal/tile/green{
	dir = 8
	},
/obj/effect/decal/cleanable/dirt/dust{
	layer = 2.032
	},
/obj/structure/table/reinforced,
/obj/item/storage/box/syringes{
	pixel_x = 5;
	pixel_y = 5
	},
/obj/item/storage/box/beakers,
/obj/effect/decal/cleanable/dirt/dust{
	layer = 2.032
	},
/obj/effect/decal/cleanable/dirt/dust{
	layer = 2.032
	},
/turf/open/floor/iron/dark,
/area/ruin/space/has_grav/abandonedzoo)
"Ck" = (
/obj/effect/turf_decal/tile/green{
	dir = 1
	},
/obj/effect/turf_decal/tile/green,
/obj/effect/turf_decal/tile/green{
	dir = 4
	},
/obj/effect/turf_decal/tile/green{
	dir = 8
	},
/obj/machinery/power/apc/unlocked{
	dir = 8;
	environ = 0;
	lighting = 0;
	name = "Worn-out APC";
	pixel_x = -25
	},
/obj/structure/cable,
/obj/effect/decal/cleanable/dirt/dust{
	layer = 2.032
	},
/turf/open/floor/iron/dark,
/area/ruin/space/has_grav/abandonedzoo)
"Ct" = (
/obj/machinery/smartfridge/chemistry,
/obj/machinery/light/directional/south,
/obj/effect/decal/cleanable/dirt/dust{
	layer = 2.032
	},
/obj/effect/decal/cleanable/dirt/dust{
	layer = 2.032
	},
/turf/open/floor/iron/dark/side{
	dir = 4
	},
/area/ruin/space/has_grav/abandonedzoo)
"CP" = (
/turf/open/floor/plating/beach/coastline_t{
	dir = 8
	},
/area/ruin/space/has_grav/abandonedzoo)
"DW" = (
/obj/machinery/power/shieldwallgen/anchored,
/obj/structure/cable,
/obj/effect/decal/cleanable/dirt/dust{
	layer = 2.032
	},
/turf/open/floor/plating,
/area/ruin/space/has_grav/abandonedzoo)
"Gp" = (
/obj/effect/turf_decal/tile/green{
	dir = 1
	},
/obj/effect/turf_decal/tile/green,
/obj/effect/turf_decal/tile/green{
	dir = 4
	},
/obj/effect/turf_decal/tile/green{
	dir = 8
	},
/obj/effect/decal/cleanable/dirt/dust{
	layer = 2.032
	},
/turf/open/floor/iron/dark,
/area/ruin/space/has_grav/abandonedzoo)
"GE" = (
/obj/effect/turf_decal/tile/green{
	dir = 1
	},
/obj/effect/turf_decal/tile/green,
/obj/effect/turf_decal/tile/green{
	dir = 4
	},
/obj/effect/turf_decal/tile/green{
	dir = 8
	},
/obj/effect/decal/cleanable/dirt/dust{
	layer = 2.032
	},
/obj/effect/decal/cleanable/dirt/dust{
	layer = 2.032
	},
/obj/effect/decal/cleanable/dirt/dust{
	layer = 2.032
	},
/turf/open/floor/iron/dark,
/area/ruin/space/has_grav/abandonedzoo)
"GX" = (
/obj/effect/turf_decal/tile/green{
	dir = 1
	},
/obj/effect/turf_decal/tile/green,
/obj/effect/turf_decal/tile/green{
	dir = 4
	},
/obj/effect/turf_decal/tile/green{
	dir = 8
	},
/obj/structure/cable,
/obj/machinery/power/terminal,
/obj/effect/decal/cleanable/dirt/dust{
	layer = 2.032
	},
/turf/open/floor/iron/dark,
/area/ruin/space/has_grav/abandonedzoo)
"Ig" = (
/obj/machinery/light/directional/north,
/mob/living/simple_animal/crab{
	faction = list("carp")
	},
/obj/item/strange_rock,
/turf/open/floor/plating/beach/sand,
/area/ruin/space/has_grav/abandonedzoo)
"Iv" = (
/turf/open/lava/smooth/lava_land_surface,
/area/ruin/space/has_grav/abandonedzoo)
"LR" = (
/obj/effect/meteor/dust,
/turf/template_noop,
/area/template_noop)
"Mb" = (
/mob/living/simple_animal/hostile/bee,
/mob/living/simple_animal/hostile/bee,
/mob/living/simple_animal/hostile/bee,
/mob/living/simple_animal/hostile/bee,
/mob/living/simple_animal/hostile/bee,
/mob/living/simple_animal/hostile/bee,
/turf/open/floor/grass,
/area/ruin/space/has_grav/abandonedzoo)
"MF" = (
/turf/open/floor/plating/beach/coastline_b{
	dir = 6
	},
/area/ruin/space/has_grav/abandonedzoo)
"MJ" = (
/mob/living/simple_animal/hostile/bee,
/mob/living/simple_animal/hostile/bee,
/mob/living/simple_animal/hostile/bee,
/mob/living/simple_animal/hostile/bee,
/mob/living/simple_animal/hostile/bee,
/mob/living/simple_animal/hostile/bee,
/obj/structure/flora/ausbushes/ywflowers,
/turf/open/floor/grass,
/area/ruin/space/has_grav/abandonedzoo)
"Ng" = (
/obj/structure/alien/weeds,
/obj/structure/alien/weeds/node,
/turf/open/floor/plating/airless,
/area/ruin/space/has_grav/abandonedzoo)
"OR" = (
/obj/structure/cable,
/obj/structure/frame/machine,
/turf/open/floor/plating/airless,
/area/ruin/space/has_grav/abandonedzoo)
"Po" = (
/obj/machinery/light/small/directional/east,
/obj/effect/turf_decal/tile/green{
	dir = 1
	},
/obj/effect/turf_decal/tile/green,
/obj/effect/turf_decal/tile/green{
	dir = 4
	},
/obj/effect/turf_decal/tile/green{
	dir = 8
	},
/obj/effect/decal/cleanable/dirt/dust{
	layer = 2.032
	},
/turf/open/floor/iron/dark,
/area/ruin/space/has_grav/abandonedzoo)
"PF" = (
/obj/machinery/light/directional/south,
/mob/living/simple_animal/hostile/bee,
/mob/living/simple_animal/hostile/bee,
/obj/structure/flora/ausbushes/palebush,
/turf/open/floor/grass,
/area/ruin/space/has_grav/abandonedzoo)
"PS" = (
/obj/effect/turf_decal/tile/green{
	dir = 1
	},
/obj/effect/turf_decal/tile/green,
/obj/effect/turf_decal/tile/green{
	dir = 4
	},
/obj/effect/turf_decal/tile/green{
	dir = 8
	},
/obj/structure/chair/office/light{
	dir = 8
	},
/obj/effect/decal/cleanable/dirt/dust{
	layer = 2.032
	},
/turf/open/floor/iron/dark,
/area/ruin/space/has_grav/abandonedzoo)
"QW" = (
/turf/open/floor/plating/beach/coastline_t{
	dir = 10
	},
/area/ruin/space/has_grav/abandonedzoo)
"TH" = (
/obj/effect/turf_decal/tile/green{
	dir = 1
	},
/obj/effect/turf_decal/tile/green,
/obj/effect/turf_decal/tile/green{
	dir = 4
	},
/obj/effect/turf_decal/tile/green{
	dir = 8
	},
/obj/effect/decal/cleanable/dirt/dust{
	layer = 2.032
	},
/obj/effect/decal/cleanable/dirt/dust{
	layer = 2.032
	},
/obj/effect/decal/cleanable/dirt/dust{
	layer = 2.032
	},
/obj/structure/cable,
/turf/open/floor/iron/dark,
/area/ruin/space/has_grav/abandonedzoo)
"Ut" = (
/obj/effect/turf_decal/tile/green{
	dir = 1
	},
/obj/effect/turf_decal/tile/green,
/obj/effect/turf_decal/tile/green{
	dir = 4
	},
/obj/effect/turf_decal/tile/green{
	dir = 8
	},
/obj/structure/table/reinforced,
/obj/machinery/reagentgrinder,
/obj/effect/decal/cleanable/dirt/dust{
	layer = 2.032
	},
/obj/effect/decal/cleanable/dirt/dust{
	layer = 2.032
	},
/turf/open/floor/iron/dark,
/area/ruin/space/has_grav/abandonedzoo)
"Wu" = (
/turf/open/floor/plating/beach/coastline_b{
	dir = 5
	},
/area/ruin/space/has_grav/abandonedzoo)

(1,1,1) = {"
ab
ac
ac
ac
ac
ab
aa
aa
aa
aa
aa
aa
ab
ac
ac
ac
ac
ab
aa
"}
(2,1,1) = {"
ac
Iv
ai
ar
ah
ac
aK
aK
aK
aK
aK
aK
ac
bu
ke
bI
bv
ac
aa
"}
(3,1,1) = {"
ac
Iv
ap
ai
ah
aD
aL
wc
aL
aL
wc
aL
aD
bu
fD
bJ
MF
ac
aa
"}
(4,1,1) = {"
ac
ai
Iv
ah
xW
ac
at
at
bb
wF
at
at
ac
Ig
fD
Wu
dj
ac
aa
"}
(5,1,1) = {"
ac
aj
ah
ah
ar
ac
aW
aO
Gp
fQ
Ck
bm
ac
bx
bE
CP
QW
ac
aa
"}
(6,1,1) = {"
ab
ac
ac
ac
ac
aP
aY
Gp
Gp
aO
bf
bn
aE
ac
ac
ac
ac
OR
aa
"}
(7,1,1) = {"
aa
aa
aa
at
aG
aS
aZ
aV
aO
aO
GX
bp
kF
by
bF
bK
bK
bR
aa
"}
(8,1,1) = {"
aa
aa
aa
ag
aO
Gp
PS
ak
AE
xi
TH
Gp
Gp
Gp
at
at
at
aa
aa
"}
(9,1,1) = {"
aa
aa
aa
ag
Gp
Gp
qt
GE
bh
bk
ay
aO
Gp
Gp
bG
rG
lo
aa
aa
"}
(10,1,1) = {"
aa
aa
aa
ag
aO
aO
aO
GE
bi
bl
ay
Gp
aO
aO
bG
Po
lo
aa
aa
"}
(11,1,1) = {"
aa
aa
aa
ag
GE
aO
Gp
Gp
Ut
da
bf
Gp
Gp
Gp
at
at
at
aa
aa
"}
(12,1,1) = {"
aa
aa
aa
at
aN
aT
bd
Gp
aO
GE
bf
br
uA
Ct
at
aa
aa
aa
aa
"}
(13,1,1) = {"
ab
ac
ac
ac
ac
DW
vk
Gp
aO
aO
bf
bA
bs
ac
ac
ac
ac
bt
aa
"}
(14,1,1) = {"
ac
al
dV
gE
aA
ac
be
aO
Gp
bf
ay
bQ
ac
bB
Ng
bD
bH
ac
aa
"}
(15,1,1) = {"
ac
MJ
Mb
ao
PF
ac
at
at
bb
wF
at
at
ac
mY
ok
bB
bH
bT
aa
"}
(16,1,1) = {"
ac
gE
aq
nY
Mb
aD
aL
kp
aL
aL
iZ
aL
aD
bD
bB
Ng
bO
bU
bW
"}
(17,1,1) = {"
ac
ao
gE
av
aC
ac
aQ
aQ
aQ
aQ
aQ
aQ
ac
ok
bB
bH
bX
bP
aa
"}
(18,1,1) = {"
ab
ac
ac
ac
ac
ab
aa
aa
aa
aa
aa
aa
bt
ac
ac
bN
bP
aa
LR
"}
(19,1,1) = {"
aa
aa
aa
aa
aa
aa
aa
aa
aa
aa
aa
aa
aa
aa
aa
LR
aa
bV
aa
"}
