//MAP CONVERTED BY dmm2tgm.py THIS HEADER COMMENT PREVENTS RECONVERSION, DO NOT REMOVE
"a" = (
/turf/template_noop,
/area/template_noop)
"b" = (
/turf/closed/mineral/random,
/area/ruin/unpowered)
"c" = (
/turf/open/floor/plating/asteroid/airless,
/area/ruin/unpowered)
"d" = (
/turf/closed/mineral/random/high_chance,
/area/ruin/unpowered)
"e" = (
/turf/closed/wall/mineral/titanium,
/area/ruin/unpowered)
"f" = (
/obj/structure/shuttle/engine/propulsion{
	dir = 4
	},
/turf/open/floor/plating/airless,
/area/ruin/unpowered)
"g" = (
/obj/structure/chair,
/obj/structure/window/reinforced{
	dir = 8
	},
/turf/open/floor/mineral/titanium/blue/airless,
/area/ruin/unpowered)
"h" = (
/obj/structure/chair,
/turf/open/floor/mineral/titanium/blue/airless,
/area/ruin/unpowered)
"i" = (
/turf/open/floor/plating/airless,
/area/ruin/unpowered)
"j" = (
/turf/open/floor/mineral/titanium/blue/airless,
/area/ruin/unpowered)
"k" = (
/obj/effect/spawner/lootdrop/crate_spawner,
/turf/open/floor/mineral/titanium/blue/airless,
/area/ruin/unpowered)
"l" = (
/obj/item/shard,
/turf/open/floor/plating/airless,
/area/ruin/unpowered)
"m" = (
/obj/structure/chair{
	dir = 8
	},
/turf/open/floor/plating/airless,
/area/ruin/unpowered)
"n" = (
/obj/structure/grille,
/turf/open/floor/plating/airless,
/area/ruin/unpowered)
"o" = (
/obj/machinery/door/airlock/titanium,
/turf/open/floor/plating/airless,
/area/ruin/unpowered)
"p" = (
/obj/structure/table,
/turf/open/floor/mineral/titanium/blue/airless,
/area/ruin/unpowered)
"q" = (
/obj/item/shard,
/obj/structure/chair{
	dir = 8
	},
/turf/open/floor/mineral/titanium/blue/airless,
/area/ruin/unpowered)
"r" = (
/obj/structure/chair{
	dir = 1
	},
/obj/structure/window/reinforced{
	dir = 8
	},
/turf/open/floor/mineral/titanium/blue/airless,
/area/ruin/unpowered)
"s" = (
/obj/structure/chair{
	dir = 1
	},
/turf/open/floor/plating/airless,
/area/ruin/unpowered)
"t" = (
/obj/structure/girder,
/turf/open/floor/plating/airless,
/area/ruin/unpowered)

(1,1,1) = {"
a
a
a
a
a
c
c
a
a
a
a
a
a
a
a
a
a
a
a
a
a
c
c
a
a
a
"}
(2,1,1) = {"
a
a
a
a
a
c
c
c
c
c
c
c
a
a
a
a
a
a
a
a
b
c
c
c
a
a
"}
(3,1,1) = {"
a
a
a
a
a
c
c
c
c
c
c
c
b
b
b
a
a
a
a
b
b
c
c
c
a
a
"}
(4,1,1) = {"
a
a
a
b
c
c
c
c
c
c
c
c
c
b
b
a
a
a
a
b
b
b
b
b
a
a
"}
(5,1,1) = {"
a
a
a
b
b
b
c
c
c
c
c
c
c
b
b
b
a
a
a
b
b
b
b
b
a
a
"}
(6,1,1) = {"
a
a
b
b
b
b
b
b
c
c
b
b
b
b
b
b
b
a
a
a
a
b
b
a
a
a
"}
(7,1,1) = {"
a
a
b
b
b
b
d
d
b
b
b
b
b
b
b
b
d
a
a
a
a
b
b
a
a
a
"}
(8,1,1) = {"
a
a
d
d
b
b
d
d
b
b
b
d
b
b
b
b
b
a
a
a
a
a
a
a
b
a
"}
(9,1,1) = {"
a
a
d
d
b
b
b
b
b
b
b
b
b
b
b
b
b
b
a
a
a
a
b
b
b
a
"}
(10,1,1) = {"
a
a
d
d
d
b
b
b
i
i
n
b
b
c
b
b
d
d
a
a
a
a
a
b
b
a
"}
(11,1,1) = {"
a
a
d
d
b
b
c
e
i
l
p
i
e
c
b
b
d
d
a
a
a
a
a
a
a
a
"}
(12,1,1) = {"
a
a
d
b
b
b
c
e
i
m
q
j
e
c
b
b
d
d
a
a
a
b
b
b
a
a
"}
(13,1,1) = {"
a
a
b
b
b
b
c
e
i
j
j
j
e
c
c
b
b
b
a
a
a
a
b
b
b
a
"}
(14,1,1) = {"
a
a
b
b
b
c
c
e
j
j
j
j
e
c
c
c
c
b
a
a
a
b
b
b
b
b
"}
(15,1,1) = {"
a
a
a
b
b
c
c
o
j
j
j
j
o
c
c
c
c
b
a
a
d
b
b
b
c
c
"}
(16,1,1) = {"
a
a
a
b
b
b
c
e
g
j
j
r
e
c
c
c
c
a
a
d
d
b
b
d
c
c
"}
(17,1,1) = {"
b
a
a
b
b
b
c
e
h
j
j
s
t
c
c
c
c
a
d
b
b
b
c
c
c
a
"}
(18,1,1) = {"
a
a
b
b
b
d
c
e
k
j
i
i
i
c
c
a
a
a
b
b
b
b
c
c
c
a
"}
(19,1,1) = {"
a
a
b
b
b
d
c
e
e
e
e
e
e
c
c
a
a
a
b
b
c
c
c
c
c
a
"}
(20,1,1) = {"
a
a
b
b
b
d
c
e
f
f
f
f
e
c
c
a
a
a
b
b
c
c
c
a
a
a
"}
(21,1,1) = {"
a
a
b
b
b
b
b
c
c
c
c
c
c
c
c
a
a
a
b
c
c
c
a
a
a
a
"}
(22,1,1) = {"
a
a
a
b
b
b
c
c
c
c
c
a
a
a
a
a
a
a
c
a
a
a
a
a
a
a
"}
(23,1,1) = {"
a
a
a
a
b
b
c
c
c
c
c
a
a
a
c
c
c
a
c
a
a
a
a
a
a
a
"}
(24,1,1) = {"
a
a
a
a
a
a
a
a
a
a
a
a
a
c
c
b
b
a
a
a
a
a
a
a
a
a
"}
(25,1,1) = {"
a
a
a
a
a
a
a
a
a
a
a
a
a
c
c
d
b
a
a
a
a
a
a
a
a
a
"}
(26,1,1) = {"
a
a
a
a
a
a
a
a
a
a
a
b
a
b
d
b
b
a
a
a
a
a
a
a
a
a
"}
(27,1,1) = {"
a
a
a
a
a
a
a
a
a
a
a
a
a
b
b
a
a
a
a
a
a
a
a
a
a
a
"}
