//MAP CONVERTED BY dmm2tgm.py THIS HEADER COMMENT PREVENTS RECONVERSION, DO NOT REMOVE
"a" = (
/turf/template_noop,
/area/template_noop)
"b" = (
/turf/closed/mineral/random,
/area/ruin/unpowered/no_grav)
"c" = (
/turf/open/floor/plating/asteroid/airless,
/area/ruin/unpowered/no_grav)
"e" = (
/turf/closed/wall,
/area/ruin/unpowered)
"f" = (
/turf/closed/wall/rust,
/area/ruin/unpowered)
"g" = (
/turf/open/floor/plating,
/area/ruin/unpowered)
"i" = (
/obj/effect/spawner/lootdrop/crate_spawner,
/turf/open/floor/plating,
/area/ruin/unpowered)
"j" = (
/obj/structure/barricade/wooden,
/obj/structure/door_assembly,
/turf/open/floor/plating,
/area/ruin/unpowered)
"k" = (
/obj/structure/table,
/obj/item/storage/toolbox/electrical,
/turf/open/floor/plating,
/area/ruin/unpowered)
"l" = (
/turf/closed/mineral/random,
/area/ruin/unpowered)
"m" = (
/obj/structure/closet/crate,
/obj/effect/spawner/lootdrop/maintenance,
/turf/open/floor/plating,
/area/ruin/unpowered)
"n" = (
/obj/effect/decal/remains/human,
/turf/open/floor/plating,
/area/ruin/unpowered)
"o" = (
/obj/structure/table,
/obj/item/storage/toolbox/syndicate,
/turf/open/floor/plating,
/area/ruin/unpowered)
"p" = (
/obj/structure/closet/crate,
/turf/open/floor/plating,
/area/ruin/unpowered)
"q" = (
/obj/structure/table,
/turf/open/floor/plating,
/area/ruin/unpowered)
"r" = (
/turf/open/floor/plating/asteroid,
/area/ruin/unpowered)
"s" = (
/obj/structure/barricade/wooden,
/turf/open/floor/plating,
/area/ruin/unpowered)
"y" = (
/obj/machinery/door/airlock/external,
/turf/open/floor/plating,
/area/ruin/unpowered)
"N" = (
/obj/structure/barricade/wooden,
/obj/machinery/door/airlock/external,
/turf/open/floor/plating/asteroid/airless,
/area/ruin/unpowered)

(1,1,1) = {"
a
a
a
a
a
a
c
c
c
c
a
a
a
a
a
a
a
a
a
b
a
a
a
b
a
a
a
a
a
a
"}
(2,1,1) = {"
a
a
a
a
c
c
c
c
c
c
a
a
a
a
a
a
b
b
a
a
a
a
a
a
a
a
a
a
a
a
"}
(3,1,1) = {"
a
a
a
b
b
b
b
b
c
c
c
c
a
a
a
a
b
b
a
a
a
b
b
b
a
a
a
a
b
a
"}
(4,1,1) = {"
a
a
b
b
b
b
b
b
c
c
c
c
c
c
a
a
a
b
a
b
a
a
b
b
a
a
a
a
a
a
"}
(5,1,1) = {"
a
a
b
b
b
b
b
b
b
b
b
c
c
c
c
a
a
a
a
b
b
a
b
b
b
a
a
a
a
a
"}
(6,1,1) = {"
a
a
b
b
b
b
b
b
b
b
b
b
b
b
c
c
a
a
a
b
a
a
a
a
a
a
a
b
b
b
"}
(7,1,1) = {"
a
b
b
b
b
b
b
b
b
b
b
b
b
b
c
c
c
a
a
a
a
a
a
a
a
a
a
b
b
a
"}
(8,1,1) = {"
a
b
b
b
b
b
b
b
b
b
b
b
b
b
b
c
c
c
a
a
a
a
a
b
b
a
a
a
a
a
"}
(9,1,1) = {"
a
b
b
b
b
b
b
b
b
b
b
b
b
b
b
c
c
c
c
a
a
a
a
b
b
b
a
a
a
a
"}
(10,1,1) = {"
a
b
b
b
b
b
l
l
f
f
e
f
e
e
e
l
b
c
c
a
a
a
a
b
b
b
b
a
a
a
"}
(11,1,1) = {"
a
b
b
b
b
b
l
g
i
i
n
g
f
g
g
l
b
c
c
c
a
c
c
b
b
b
b
b
a
a
"}
(12,1,1) = {"
a
a
a
b
b
b
e
g
g
g
g
p
f
g
g
e
b
c
c
c
c
c
c
c
b
b
b
b
b
a
"}
(13,1,1) = {"
a
a
a
b
b
b
e
g
g
k
o
i
e
g
g
l
b
c
c
c
c
c
c
c
c
b
b
b
b
b
"}
(14,1,1) = {"
a
a
a
b
b
b
f
e
j
f
f
e
e
r
m
e
b
c
c
c
c
c
c
c
c
b
b
b
b
b
"}
(15,1,1) = {"
a
a
a
a
b
b
l
g
g
m
p
m
e
g
g
f
b
c
c
c
c
c
c
c
c
b
b
b
b
b
"}
(16,1,1) = {"
a
b
a
a
b
b
l
g
g
g
g
g
e
g
r
f
b
b
c
c
c
c
c
c
c
b
b
b
b
b
"}
(17,1,1) = {"
a
a
a
a
b
b
e
g
g
g
g
g
j
g
g
e
b
b
b
c
c
c
c
c
c
b
b
b
b
b
"}
(18,1,1) = {"
a
a
a
a
a
b
e
p
p
g
q
g
e
g
r
e
e
e
b
c
c
c
c
c
c
b
b
b
b
b
"}
(19,1,1) = {"
a
a
a
a
a
b
l
f
f
j
f
g
e
r
s
N
s
y
c
c
c
c
c
c
b
b
b
b
b
a
"}
(20,1,1) = {"
a
a
b
b
a
a
l
i
p
g
f
m
e
e
l
e
e
e
b
c
c
c
c
b
b
b
b
b
b
a
"}
(21,1,1) = {"
a
b
b
b
a
a
b
b
e
f
e
b
b
b
b
b
b
b
b
c
c
c
c
b
b
b
b
b
a
a
"}
(22,1,1) = {"
a
b
b
b
b
a
b
b
b
b
b
b
b
b
b
b
b
b
b
b
b
b
b
b
b
b
b
a
a
a
"}
(23,1,1) = {"
a
a
b
b
b
a
a
b
b
b
b
b
b
b
b
b
b
b
b
b
b
b
b
b
b
b
b
a
a
a
"}
(24,1,1) = {"
a
a
a
a
a
a
a
a
b
b
b
b
b
b
b
b
b
b
b
b
b
b
b
b
b
b
a
a
a
a
"}
(25,1,1) = {"
a
b
a
a
a
a
a
a
b
b
b
b
b
b
b
b
b
b
b
b
b
b
b
b
b
a
a
a
a
a
"}
(26,1,1) = {"
a
b
a
a
a
a
a
a
a
b
b
b
b
b
b
b
b
b
b
b
b
b
b
b
b
a
a
a
a
a
"}
(27,1,1) = {"
a
a
a
a
b
a
a
a
a
a
b
b
b
b
b
b
b
b
b
b
b
b
b
b
a
a
a
a
a
a
"}
(28,1,1) = {"
a
a
a
a
a
a
b
a
a
a
a
b
b
b
b
b
b
b
b
b
b
b
a
a
a
a
a
a
a
a
"}
(29,1,1) = {"
a
b
a
a
a
a
a
a
a
a
a
a
a
b
b
b
b
b
b
b
b
a
a
a
a
a
a
a
a
a
"}
