//MAP CONVERTED BY dmm2tgm.py THIS HEADER COMMENT PREVENTS RECONVERSION, DO NOT REMOVE
"a" = (
/turf/template_noop,
/area/template_noop)
"b" = (
/obj/effect/mapping_helpers/smart_pipe/manifold4w/scrubbers/hidden/layer2,
/obj/effect/mapping_helpers/smart_pipe/manifold4w/supply/hidden/layer4,
/turf/open/floor/plating/rust,
/area/template_noop)
"c" = (
/obj/effect/spawner/structure/window/reinforced,
/turf/open/floor/plating,
/area/ruin/space/has_grav/powered/dinner_for_two)
"d" = (
/obj/effect/spawner/structure/window/reinforced,
/obj/effect/spawner/structure/window/reinforced,
/turf/open/floor/plating,
/area/ruin/space/has_grav/powered/dinner_for_two)
"e" = (
/obj/effect/mapping_helpers/smart_pipe/manifold4w/scrubbers/hidden/layer2,
/obj/machinery/door/airlock/alarmlock,
/turf/open/floor/plating/rust,
/area/template_noop)
"f" = (
/turf/closed/wall,
/area/ruin/space/has_grav/powered/dinner_for_two)
"h" = (
/turf/open/floor/iron/textured,
/area/ruin/space/has_grav/powered/dinner_for_two)
"j" = (
/obj/effect/decal/cleanable/dirt/dust,
/obj/machinery/atmospherics/components/unary/vent_scrubber/layer2,
/turf/open/floor/iron/textured,
/area/ruin/space/has_grav/powered/dinner_for_two)
"k" = (
/turf/open/floor/plating,
/area/ruin/space/has_grav/powered/dinner_for_two)
"l" = (
/obj/machinery/light/broken/directional/west,
/turf/open/floor/plating,
/area/ruin/space/has_grav/powered/dinner_for_two)
"m" = (
/turf/open/floor/plating/rust,
/area/ruin/space/has_grav/powered/dinner_for_two)
"n" = (
/obj/effect/decal/cleanable/dirt/dust,
/obj/effect/mapping_helpers/smart_pipe/manifold4w/scrubbers/hidden/layer2,
/turf/open/floor/iron/textured,
/area/ruin/space/has_grav/powered/dinner_for_two)
"o" = (
/obj/effect/decal/cleanable/dirt/dust,
/turf/open/floor/plating/rust,
/area/ruin/space/has_grav/powered/dinner_for_two)
"p" = (
/obj/effect/decal/cleanable/dirt/dust,
/obj/machinery/light/broken/directional/east,
/turf/open/floor/iron/textured,
/area/ruin/space/has_grav/powered/dinner_for_two)
"q" = (
/turf/closed/wall/rust,
/area/ruin/space/has_grav/powered/dinner_for_two)
"r" = (
/obj/effect/decal/cleanable/dirt/dust,
/turf/open/floor/iron/textured,
/area/ruin/space/has_grav/powered/dinner_for_two)
"v" = (
/obj/structure/chair{
	dir = 8
	},
/obj/effect/decal/remains/human,
/obj/effect/mapping_helpers/smart_pipe/manifold4w/supply/hidden/layer4,
/obj/effect/mapping_helpers/smart_pipe/manifold4w/scrubbers/hidden/layer2,
/turf/open/floor/plating,
/area/ruin/space/has_grav/powered/dinner_for_two)
"x" = (
/obj/machinery/door/airlock/alarmlock,
/obj/effect/mapping_helpers/smart_pipe/manifold4w/supply/hidden/layer4,
/obj/effect/mapping_helpers/smart_pipe/manifold4w/scrubbers/hidden/layer2,
/turf/open/floor/plating/rust,
/area/ruin/space/has_grav/powered/dinner_for_two)
"y" = (
/obj/machinery/atmospherics/components/unary/vent_pump/layer4{
	dir = 1
	},
/turf/open/floor/plating/rust,
/area/ruin/space/has_grav/powered/dinner_for_two)
"z" = (
/obj/effect/decal/cleanable/dirt/dust,
/obj/machinery/light/broken/directional/west,
/turf/open/floor/iron/textured,
/area/ruin/space/has_grav/powered/dinner_for_two)
"A" = (
/obj/effect/spawner/structure/window/reinforced,
/turf/open/floor/plating/rust,
/area/template_noop)
"B" = (
/obj/effect/mapping_helpers/smart_pipe/manifold4w/supply/hidden/layer4,
/turf/open/floor/plating,
/area/ruin/space/has_grav/powered/dinner_for_two)
"C" = (
/obj/effect/mapping_helpers/smart_pipe/manifold4w/supply/hidden/layer4,
/obj/effect/mapping_helpers/smart_pipe/manifold4w/scrubbers/hidden/layer2,
/turf/open/floor/iron/textured,
/area/ruin/space/has_grav/powered/dinner_for_two)
"E" = (
/obj/structure/lattice,
/turf/template_noop,
/area/template_noop)
"I" = (
/obj/structure/table,
/obj/item/candle{
	pixel_y = 5
	},
/obj/item/plate{
	pixel_x = 10
	},
/obj/item/plate{
	pixel_x = -10
	},
/obj/effect/decal/cleanable/dirt/dust,
/obj/effect/mapping_helpers/smart_pipe/manifold4w/supply/hidden/layer4,
/obj/effect/mapping_helpers/smart_pipe/manifold4w/scrubbers/hidden/layer2,
/turf/open/floor/iron/textured,
/area/ruin/space/has_grav/powered/dinner_for_two)
"M" = (
/obj/machinery/light/red/directional/east,
/turf/open/floor/plating/rust,
/area/ruin/space/has_grav/powered/dinner_for_two)
"V" = (
/obj/structure/chair{
	dir = 4
	},
/obj/effect/decal/remains/human,
/obj/effect/decal/cleanable/dirt/dust,
/turf/open/floor/iron/textured,
/area/ruin/space/has_grav/powered/dinner_for_two)
"Z" = (
/turf/closed/wall/rust,
/area/template_noop)

(1,1,1) = {"
a
f
c
c
c
q
a
"}
(2,1,1) = {"
f
m
l
r
z
k
f
"}
(3,1,1) = {"
c
h
m
V
k
k
c
"}
(4,1,1) = {"
c
j
n
I
B
y
c
"}
(5,1,1) = {"
d
k
o
v
r
r
c
"}
(6,1,1) = {"
q
o
p
C
M
k
f
"}
(7,1,1) = {"
a
q
q
x
q
q
a
"}
(8,1,1) = {"
a
a
A
b
A
a
a
"}
(9,1,1) = {"
a
a
E
e
Z
a
a
"}
