//MAP CONVERTED BY dmm2tgm.py THIS HEADER COMMENT PREVENTS RECONVERSION, DO NOT REMOVE
"aa" = (
/turf/template_noop,
/area/template_noop)
"ab" = (
/obj/effect/decal/cleanable/dirt,
/obj/machinery/atmospherics/components/unary/vent_scrubber/on/layer2,
/turf/open/floor/iron/textured,
/area/ruin/space/djstation)
"ac" = (
/obj/machinery/power/solar/fake,
/obj/structure/cable,
/turf/open/floor/iron/solarpanel/airless,
/area/ruin/space/djstation/solars)
"ad" = (
/obj/structure/cable,
/obj/structure/lattice/catwalk,
/obj/structure/lattice,
/turf/template_noop,
/area/space/nearstation)
"ae" = (
/obj/structure/lattice,
/turf/template_noop,
/area/space/nearstation)
"af" = (
/obj/structure/marker_beacon/white,
/obj/structure/lattice/catwalk,
/turf/template_noop,
/area/space/nearstation)
"ag" = (
/obj/structure/window/shuttle/survival_pod,
/obj/structure/grille,
/obj/structure/low_wall,
/turf/open/floor/plating,
/area/ruin/space/djstation)
"ah" = (
/obj/structure/cable,
/obj/effect/decal/cleanable/dirt/dust,
/obj/machinery/power/terminal{
	dir = 1
	},
/obj/structure/lattice/catwalk/plated/textured,
/turf/open/floor/plating,
/area/ruin/space/djstation)
"ai" = (
/obj/effect/mapping_helpers/smart_pipe/manifold4w/supply/hidden/layer4,
/obj/effect/mapping_helpers/smart_pipe/manifold4w/scrubbers/hidden/layer2,
/turf/open/floor/iron/textured,
/area/ruin/space/djstation)
"aj" = (
/obj/effect/decal/cleanable/dirt,
/obj/machinery/atmospherics/components/unary/vent_pump/on/layer4{
	dir = 4
	},
/turf/open/floor/iron/textured,
/area/ruin/space/djstation)
"ak" = (
/obj/effect/decal/cleanable/dirt,
/obj/effect/mapping_helpers/smart_pipe/manifold4w/supply/hidden/layer4,
/obj/machinery/atmospherics/components/unary/portables_connector/layer2,
/obj/machinery/portable_atmospherics/canister,
/turf/open/floor/iron/textured,
/area/ruin/space/djstation)
"al" = (
/obj/machinery/door/airlock/maintenance_hatch,
/obj/effect/mapping_helpers/smart_pipe/manifold4w/supply/hidden/layer4,
/obj/effect/mapping_helpers/smart_pipe/manifold4w/scrubbers/hidden/layer2,
/turf/open/floor/iron/textured,
/area/ruin/space/djstation)
"am" = (
/obj/structure/cable,
/obj/machinery/door/airlock/external/glass{
	dir = 4
	},
/obj/effect/mapping_helpers/airlock/cyclelink_helper_multi,
/obj/structure/lattice/catwalk/plated/textured,
/turf/open/floor/plating,
/area/ruin/space/djstation)
"an" = (
/obj/structure/cable,
/obj/structure/lattice/catwalk,
/turf/template_noop,
/area/space/nearstation)
"ao" = (
/obj/machinery/light_switch/directional/north,
/obj/effect/decal/cleanable/dirt,
/obj/effect/mapping_helpers/smart_pipe/manifold4w/supply/hidden/layer4,
/obj/effect/mapping_helpers/smart_pipe/manifold4w/scrubbers/hidden/layer2,
/obj/machinery/newscaster/directional/north,
/obj/effect/spawner/lootdrop/space/syndiecosmetic,
/obj/structure/closet/crate,
/turf/open/floor/iron/textured,
/area/ruin/space/djstation)
"ap" = (
/obj/structure/window/shuttle/survival_pod,
/obj/structure/grille,
/obj/structure/low_wall,
/obj/machinery/door/poddoor/shutters/preopen{
	id = "djstationengineering";
	dir = 4
	},
/turf/open/floor/plating,
/area/ruin/space/djstation)
"aq" = (
/obj/effect/decal/cleanable/dirt,
/obj/machinery/button/door/directional/south{
	id = "djstationengineering"
	},
/obj/structure/rack,
/obj/item/multitool,
/obj/item/storage/toolbox/mechanical{
	pixel_x = -2;
	pixel_y = -1
	},
/turf/open/floor/iron/textured,
/area/ruin/space/djstation)
"ar" = (
/obj/effect/decal/cleanable/dirt,
/obj/effect/mapping_helpers/smart_pipe/manifold4w/supply/hidden/layer4,
/obj/effect/mapping_helpers/smart_pipe/manifold4w/scrubbers/hidden/layer2,
/obj/machinery/telecomms/relay/preset/ruskie{
	pixel_y = 16;
	layer = 3.01
	},
/turf/open/floor/iron/textured,
/area/ruin/space/djstation)
"as" = (
/obj/machinery/door/airlock/public/glass{
	name = "Rest Room";
	dir = 4
	},
/obj/effect/mapping_helpers/smart_pipe/manifold4w/supply/hidden/layer4,
/obj/effect/mapping_helpers/smart_pipe/manifold4w/scrubbers/hidden/layer2,
/turf/open/floor/iron/textured,
/area/ruin/space/djstation)
"at" = (
/obj/structure/marker_beacon/olive,
/obj/structure/lattice/catwalk,
/turf/template_noop,
/area/space/nearstation)
"au" = (
/obj/structure/closet/emcloset,
/obj/effect/mapping_helpers/smart_pipe/manifold4w/supply/hidden/layer4,
/obj/effect/mapping_helpers/smart_pipe/manifold4w/scrubbers/hidden/layer2,
/turf/open/floor/iron/textured,
/area/ruin/space/djstation)
"av" = (
/obj/machinery/light/small/directional/north,
/obj/effect/mapping_helpers/smart_pipe/manifold4w/supply/hidden/layer4,
/obj/effect/mapping_helpers/smart_pipe/manifold4w/scrubbers/hidden/layer2,
/obj/effect/spawner/lootdrop/crate_spawner,
/obj/effect/spawner/lootdrop/maintenance,
/obj/effect/spawner/lootdrop/maintenance,
/turf/open/floor/iron/textured,
/area/ruin/space/djstation)
"aw" = (
/obj/effect/decal/cleanable/dirt,
/obj/effect/mapping_helpers/smart_pipe/manifold4w/supply/hidden/layer4,
/obj/machinery/atmospherics/components/unary/vent_scrubber/on/layer2{
	dir = 8
	},
/turf/open/floor/iron/grimy,
/area/ruin/space/djstation)
"ax" = (
/obj/effect/decal/cleanable/dirt,
/obj/machinery/atmospherics/components/unary/vent_pump/on/layer4{
	dir = 8
	},
/obj/structure/chair/office/light{
	dir = 1
	},
/turf/open/floor/iron/grimy,
/area/ruin/space/djstation)
"ay" = (
/obj/structure/bed,
/obj/item/bedsheet/random,
/turf/open/floor/iron/grimy,
/area/ruin/space/djstation)
"az" = (
/obj/machinery/door/airlock/external{
	name = "Ruskie DJ Station"
	},
/obj/effect/decal/cleanable/dirt,
/obj/effect/mapping_helpers/airlock/cyclelink_helper_multi,
/turf/open/floor/plating,
/area/ruin/space/djstation)
"aB" = (
/obj/machinery/sleeper,
/obj/machinery/vending/wallmed/directional/north,
/turf/open/floor/iron/grimy,
/area/ruin/space/djstation)
"aC" = (
/obj/effect/decal/cleanable/dirt,
/obj/item/flashlight/lamp{
	pixel_y = 14
	},
/obj/structure/table,
/obj/item/paper_bin{
	pixel_x = 16;
	pixel_y = 9
	},
/obj/machinery/light_switch/directional/north,
/obj/effect/spawner/lootdrop/minor/pen,
/turf/open/floor/iron/grimy,
/area/ruin/space/djstation)
"aD" = (
/obj/structure/cable,
/obj/effect/decal/cleanable/dirt,
/obj/structure/lattice/catwalk,
/turf/template_noop,
/area/space/nearstation)
"aE" = (
/obj/structure/table,
/turf/open/floor/iron/grimy,
/area/ruin/space/djstation)
"aG" = (
/obj/machinery/door/airlock/public/glass{
	name = "Kitchen";
	dir = 4
	},
/obj/effect/mapping_helpers/smart_pipe/manifold4w/supply/hidden/layer4,
/obj/effect/mapping_helpers/smart_pipe/manifold4w/scrubbers/hidden/layer2,
/turf/open/floor/iron/textured,
/area/ruin/space/djstation)
"aH" = (
/obj/item/radio/intercom{
	dir = 8;
	freerange = 1;
	name = "Pirate Radio Listening Channel"
	},
/obj/effect/decal/cleanable/dirt/dust,
/obj/structure/table/reinforced/plastitaniumglass,
/obj/machinery/atmospherics/components/unary/vent_scrubber/on/layer2{
	dir = 8
	},
/turf/open/floor/plating,
/area/ruin/space/djstation)
"aI" = (
/obj/structure/chair/office/light,
/turf/open/floor/plating,
/area/ruin/space/djstation)
"aJ" = (
/obj/item/radio/intercom{
	dir = 8;
	freerange = 1;
	name = "Pirate Radio Listening Channel"
	},
/obj/effect/decal/cleanable/dirt/dust,
/obj/structure/table/reinforced/plastitaniumglass,
/obj/machinery/atmospherics/components/unary/vent_pump/on/layer4{
	dir = 4
	},
/turf/open/floor/plating,
/area/ruin/space/djstation)
"aK" = (
/obj/structure/marker_beacon/burgundy,
/obj/structure/lattice/catwalk,
/turf/template_noop,
/area/space/nearstation)
"aN" = (
/obj/machinery/disposal/bin,
/obj/structure/disposalpipe/trunk,
/obj/effect/decal/cleanable/dirt/dust,
/turf/open/floor/iron/cafeteria,
/area/ruin/space/djstation)
"aO" = (
/obj/effect/decal/cleanable/dirt/dust,
/obj/structure/table,
/obj/item/thermometer/pen,
/obj/machinery/light/small/directional/south,
/turf/open/floor/iron/cafeteria,
/area/ruin/space/djstation)
"aP" = (
/obj/effect/spawner/lootdrop/maintenance,
/obj/effect/decal/cleanable/dirt/dust,
/obj/structure/table/reinforced/plastitaniumglass,
/turf/open/floor/plating,
/area/ruin/space/djstation)
"aQ" = (
/obj/item/radio/intercom{
	broadcasting = 1;
	dir = 8;
	freerange = 1;
	listening = 0;
	name = "Pirate Radio Broadcast Channel"
	},
/obj/structure/table/reinforced/plastitaniumglass,
/turf/open/floor/plating,
/area/ruin/space/djstation)
"aR" = (
/obj/item/paper/fluff/ruins/djstation,
/obj/effect/decal/cleanable/dirt/dust,
/obj/structure/table/reinforced/plastitaniumglass,
/turf/open/floor/plating,
/area/ruin/space/djstation)
"aS" = (
/obj/effect/decal/cleanable/dirt,
/obj/machinery/button/door/directional/south{
	id = "djstationbedroom"
	},
/obj/effect/spawner/lootdrop/medkit,
/obj/effect/spawner/lootdrop/maintenance,
/obj/effect/spawner/lootdrop/clothes,
/obj/structure/closet,
/turf/open/floor/iron/grimy,
/area/ruin/space/djstation)
"aT" = (
/obj/effect/decal/cleanable/dirt,
/obj/machinery/light/small/directional/south,
/turf/open/floor/iron/grimy,
/area/ruin/space/djstation)
"aV" = (
/obj/structure/window/shuttle/survival_pod,
/obj/structure/grille,
/obj/structure/low_wall,
/obj/machinery/door/poddoor/shutters/preopen{
	id = "djstationbedroom";
	dir = 4
	},
/turf/open/floor/plating,
/area/ruin/space/djstation)
"aW" = (
/obj/structure/disposalpipe/segment,
/obj/effect/mapping_helpers/paint_wall/skyline/inner_hull/cook,
/turf/closed/wall,
/area/ruin/space/djstation)
"aX" = (
/obj/machinery/door/airlock/hatch{
	name = "Washroom"
	},
/turf/open/floor/iron/freezer,
/area/ruin/space/djstation)
"aY" = (
/obj/machinery/light/directional/east,
/obj/effect/decal/cleanable/dirt/dust,
/turf/open/floor/iron/textured,
/area/ruin/space/djstation)
"aZ" = (
/obj/structure/disposalpipe/segment,
/obj/structure/lattice,
/turf/template_noop,
/area/space/nearstation)
"bb" = (
/obj/item/clothing/suit/space/orange,
/obj/item/clothing/mask/breath,
/obj/structure/rack,
/obj/item/clothing/head/helmet/space/orange,
/obj/structure/window/reinforced{
	dir = 1
	},
/turf/open/floor/iron/textured,
/area/ruin/space/djstation)
"be" = (
/obj/structure/sink{
	dir = 4;
	pixel_x = -12;
	pixel_y = 2
	},
/obj/machinery/light/small/directional/south,
/obj/effect/decal/cleanable/dirt/dust,
/turf/open/floor/iron/freezer,
/area/ruin/space/djstation)
"bf" = (
/obj/structure/toilet{
	pixel_y = 8
	},
/turf/open/floor/iron/freezer,
/area/ruin/space/djstation)
"bg" = (
/obj/structure/sign/warning/vacuum/external{
	pixel_y = -32
	},
/obj/effect/decal/cleanable/dirt,
/obj/structure/rack,
/obj/effect/turf_decal/stripes/asteroid/line,
/turf/open/floor/iron/textured,
/area/ruin/space/djstation)
"bi" = (
/obj/machinery/door/airlock/external{
	name = "Ruskie DJ Station"
	},
/obj/effect/mapping_helpers/airlock/cyclelink_helper,
/obj/effect/decal/cleanable/dirt,
/turf/open/floor/plating,
/area/ruin/space/djstation)
"bj" = (
/obj/structure/disposalpipe/trunk{
	dir = 1
	},
/obj/structure/disposaloutlet,
/turf/template_noop,
/area/space/nearstation)
"cp" = (
/obj/machinery/power/smes/magical{
	desc = "A high-capacity superconducting magnetic energy storage (SMES) unit.";
	name = "power storage unit"
	},
/obj/structure/cable,
/obj/structure/lattice/catwalk/plated/textured,
/turf/open/floor/plating,
/area/ruin/space/djstation)
"ct" = (
/obj/effect/decal/cleanable/dirt/dust,
/obj/effect/mapping_helpers/smart_pipe/manifold4w/supply/hidden/layer4,
/turf/open/floor/iron/cafeteria,
/area/ruin/space/djstation)
"cN" = (
/obj/effect/decal/cleanable/dirt,
/obj/effect/mapping_helpers/smart_pipe/manifold4w/supply/hidden/layer4,
/obj/effect/mapping_helpers/smart_pipe/manifold4w/scrubbers/hidden/layer2,
/turf/open/floor/iron/textured,
/area/ruin/space/djstation)
"fj" = (
/obj/effect/mapping_helpers/smart_pipe/manifold4w/supply/hidden/layer4,
/obj/machinery/atmospherics/components/binary/pump/layer2{
	dir = 1
	},
/obj/structure/lattice/catwalk/plated/textured,
/turf/open/floor/plating,
/area/ruin/space/djstation)
"hk" = (
/obj/machinery/computer/security/telescreen/entertainment/directional/south,
/turf/open/floor/iron/textured,
/area/ruin/space/djstation)
"jz" = (
/obj/effect/decal/cleanable/dirt/dust,
/obj/effect/mapping_helpers/smart_pipe/manifold4w/supply/hidden/layer4,
/obj/machinery/atmospherics/components/unary/vent_scrubber/on/layer2{
	dir = 4
	},
/turf/open/floor/iron/cafeteria,
/area/ruin/space/djstation)
"lq" = (
/obj/effect/decal/cleanable/dirt,
/turf/open/floor/plating,
/area/ruin/space/djstation)
"nx" = (
/obj/effect/mapping_helpers/paint_wall/skyline/inner_hull/cook,
/obj/effect/mapping_helpers/paint_wall/skyline/inner_hull/cook,
/turf/closed/wall,
/area/ruin/space/djstation)
"rh" = (
/obj/structure/cable,
/obj/machinery/power/tracker,
/turf/open/floor/iron/solarpanel/airless,
/area/ruin/space/djstation/solars)
"ru" = (
/obj/effect/turf_decal/stripes/asteroid/line,
/turf/open/floor/iron/textured,
/area/ruin/space/djstation)
"td" = (
/obj/effect/decal/cleanable/dirt/dust,
/obj/effect/mapping_helpers/smart_pipe/manifold4w/supply/hidden/layer4,
/obj/effect/mapping_helpers/smart_pipe/manifold4w/scrubbers/hidden/layer2,
/obj/machinery/cell_charger{
	layer = 3.01
	},
/obj/structure/table,
/obj/structure/lattice/catwalk/plated/textured,
/turf/open/floor/plating,
/area/ruin/space/djstation)
"ts" = (
/obj/structure/cable,
/obj/machinery/power/solar_control{
	dir = 4
	},
/obj/structure/lattice/catwalk/plated/textured,
/turf/open/floor/plating,
/area/ruin/space/djstation)
"uk" = (
/obj/machinery/atmospherics/components/unary/vent_pump/on/layer4{
	dir = 4
	},
/turf/open/floor/iron/cafeteria,
/area/ruin/space/djstation)
"yY" = (
/obj/machinery/light/directional/north,
/obj/structure/cable,
/obj/machinery/power/apc/auto_name/north,
/obj/structure/lattice/catwalk/plated/textured,
/turf/open/floor/plating,
/area/ruin/space/djstation)
"zb" = (
/obj/effect/mapping_helpers/paint_wall/skyline/inner_hull/cook,
/turf/closed/wall,
/area/ruin/space/djstation)
"Au" = (
/obj/machinery/space_heater{
	pixel_y = 16;
	layer = 3.1;
	pixel_x = 9
	},
/obj/structure/tank_holder/extinguisher/advanced{
	layer = 3.11;
	pixel_x = 8
	},
/obj/effect/mapping_helpers/smart_pipe/manifold4w/supply/hidden/layer4,
/obj/effect/mapping_helpers/smart_pipe/manifold4w/scrubbers/hidden/layer2,
/obj/structure/lattice/catwalk/plated/textured,
/turf/open/floor/plating,
/area/ruin/space/djstation)
"Bb" = (
/obj/machinery/power/solar/fake,
/obj/structure/cable,
/obj/effect/decal/cleanable/dirt,
/turf/open/floor/iron/solarpanel/airless,
/area/ruin/space/djstation/solars)
"BH" = (
/obj/structure/disposalpipe/segment,
/turf/template_noop,
/area/space/nearstation)
"BY" = (
/obj/effect/decal/cleanable/dirt,
/obj/structure/rack,
/obj/item/storage/box/lights/mixed,
/turf/open/floor/iron/textured,
/area/ruin/space/djstation)
"Co" = (
/obj/machinery/door/airlock/external{
	name = "Ruskie DJ Station"
	},
/obj/effect/mapping_helpers/airlock/cyclelink_helper{
	dir = 1
	},
/turf/open/floor/plating,
/area/ruin/space/djstation)
"CU" = (
/obj/structure/cable,
/obj/effect/decal/cleanable/dirt,
/obj/structure/lattice/catwalk/plated/dark,
/turf/open/floor/plating/airless,
/area/ruin/space/djstation/solars)
"KA" = (
/obj/effect/decal/cleanable/dirt/dust,
/obj/item/mop,
/obj/item/reagent_containers/glass/bucket,
/obj/structure/reagent_dispensers/watertank,
/obj/machinery/door/window/survival_pod{
	dir = 8
	},
/turf/open/floor/iron/freezer,
/area/ruin/space/djstation)
"KU" = (
/turf/open/floor/iron/textured,
/area/ruin/space/djstation)
"Lm" = (
/obj/effect/decal/cleanable/dirt/dust,
/obj/machinery/vending/snack,
/turf/open/floor/iron/cafeteria,
/area/ruin/space/djstation)
"ME" = (
/obj/structure/table,
/obj/machinery/microwave{
	pixel_y = 8;
	dir = 1
	},
/turf/open/floor/iron/cafeteria,
/area/ruin/space/djstation)
"NH" = (
/obj/effect/mapping_helpers/smart_pipe/manifold4w/supply/hidden/layer4,
/turf/open/floor/iron/grimy,
/area/ruin/space/djstation)
"OW" = (
/obj/effect/decal/cleanable/dirt/dust,
/obj/structure/table,
/obj/effect/spawner/lootdrop/donkpockets,
/turf/open/floor/iron/cafeteria,
/area/ruin/space/djstation)
"Vk" = (
/obj/structure/window/shuttle/survival_pod,
/obj/structure/grille,
/obj/structure/low_wall,
/obj/machinery/door/poddoor/shutters/preopen{
	id = "djstationengineering"
	},
/turf/open/floor/plating,
/area/ruin/space/djstation)
"Vq" = (
/obj/effect/decal/cleanable/dirt/dust,
/obj/structure/table/rolling,
/obj/item/storage/bag/tray/cafeteria{
	pixel_y = 7;
	pixel_x = -1
	},
/turf/open/floor/iron/cafeteria,
/area/ruin/space/djstation)
"Yn" = (
/obj/effect/decal/cleanable/dirt/dust,
/turf/open/floor/iron/textured,
/area/ruin/space/djstation)
"Zh" = (
/obj/structure/cable,
/obj/effect/decal/cleanable/dirt/dust,
/obj/structure/lattice/catwalk/plated/textured,
/turf/open/floor/plating,
/area/ruin/space/djstation/solars)
"ZF" = (
/obj/effect/decal/cleanable/dirt,
/obj/machinery/portable_atmospherics/canister/air,
/obj/machinery/atmospherics/components/unary/portables_connector/layer4,
/turf/open/floor/iron/textured,
/area/ruin/space/djstation)

(1,1,1) = {"
Bb
ac
ac
Bb
Bb
Bb
CU
Bb
Bb
Bb
Bb
Bb
Bb
aa
aa
aa
aa
aa
aa
aa
aa
aa
aa
aa
aa
aa
aa
aa
aa
aa
aa
aa
"}
(2,1,1) = {"
Bb
ac
ac
Bb
Bb
Bb
CU
Bb
Bb
Bb
Bb
Bb
Bb
aa
aa
aa
aa
aa
aa
aa
aa
aa
aa
aa
aa
aa
aa
aa
aa
aa
aa
aa
"}
(3,1,1) = {"
aa
ae
aa
aa
aa
aa
CU
aa
aa
aa
aa
ae
aa
aa
aa
aa
aa
aa
aa
aa
aa
aa
aa
aa
aa
aa
aa
aa
aa
aa
aa
aa
"}
(4,1,1) = {"
Bb
Bb
Bb
Bb
Bb
Bb
CU
Bb
Bb
Bb
ac
Bb
ac
aa
aa
aa
aa
aa
aa
aa
aa
aa
aa
aa
aa
aa
aa
aa
aa
aa
aa
aa
"}
(5,1,1) = {"
Bb
Bb
Bb
Bb
Bb
Bb
CU
ac
Bb
Bb
ac
Bb
ac
aa
aa
aa
aa
aa
aa
aa
aa
aa
aa
aa
aa
aa
aa
aa
aa
aa
aa
aa
"}
(6,1,1) = {"
aa
ae
aa
aa
aa
aa
CU
aa
aa
aa
aa
ae
ae
ae
ae
ae
ae
at
ae
ae
ae
ae
zb
ag
ag
ag
zb
BH
BH
aZ
bj
aa
"}
(7,1,1) = {"
Bb
Bb
Bb
ac
Bb
ac
CU
Bb
Bb
Bb
Bb
Bb
Bb
aa
aa
aa
aa
ae
aa
aa
aa
aa
zb
ME
uk
aN
aW
aa
aa
ae
aa
aa
"}
(8,1,1) = {"
ac
Bb
Bb
ac
Bb
ac
CU
Bb
Bb
Bb
Bb
Bb
Bb
aa
aa
aa
aa
ae
aa
aa
aa
aa
zb
OW
ct
aO
zb
aa
aa
ae
aa
aa
"}
(9,1,1) = {"
aa
ae
aa
aa
aa
aa
CU
aa
aa
aa
aa
ae
aa
aa
aa
aa
aa
zb
zb
zb
aa
aa
zb
Lm
jz
Vq
zb
aa
aa
ae
aa
aa
"}
(10,1,1) = {"
Bb
Bb
Bb
Bb
Bb
Bb
CU
Bb
Bb
Bb
Bb
Bb
Bb
aa
an
an
an
az
Zh
zb
aa
zb
zb
ag
aG
ag
zb
zb
zb
zb
zb
zb
"}
(11,1,1) = {"
Bb
Bb
Bb
Bb
Bb
Bb
CU
Bb
Bb
Bb
Bb
Bb
Bb
aa
an
zb
ap
zb
am
zb
ap
nx
au
cN
cN
Yn
Yn
KU
ru
bi
lq
Co
"}
(12,1,1) = {"
aa
ae
aa
aa
aa
aa
CU
aa
aa
aa
aa
ae
aa
aa
an
Vk
ts
cp
ah
BY
aq
zb
av
Yn
aH
aP
KU
bb
bg
zb
zb
zb
"}
(13,1,1) = {"
af
rh
ad
ad
ad
ad
CU
an
an
an
an
an
an
aD
an
zb
yY
aj
KU
ab
ai
al
ai
Yn
aI
aQ
hk
zb
zb
zb
aa
af
"}
(14,1,1) = {"
aa
ae
aa
aa
aa
aa
CU
aa
aa
aa
aa
ae
aa
aa
aa
Vk
ZF
ak
fj
td
Au
zb
ao
Yn
aJ
aR
Yn
aX
be
zb
aa
aa
"}
(15,1,1) = {"
Bb
ac
ac
Bb
Bb
Bb
CU
Bb
ac
ac
Bb
Bb
Bb
aa
aa
zb
ap
ap
ap
ap
ap
zb
ar
ai
ai
KU
aY
zb
bf
zb
aa
aa
"}
(16,1,1) = {"
Bb
ac
ac
Bb
Bb
Bb
CU
Bb
ac
ac
Bb
Bb
Bb
aa
aa
aa
aa
ae
aa
aa
aa
zb
zb
aV
as
aV
zb
zb
KA
zb
aa
aa
"}
(17,1,1) = {"
aa
ae
aa
aa
aa
aa
CU
aa
aa
aa
aa
ae
aa
aa
aa
aa
aa
ae
aa
aa
aa
aa
zb
aB
aw
aS
zb
zb
zb
zb
aa
aa
"}
(18,1,1) = {"
Bb
Bb
Bb
Bb
Bb
Bb
CU
Bb
Bb
Bb
Bb
Bb
Bb
aa
aa
aa
aa
ae
aa
aa
aa
aa
zb
aC
NH
aT
zb
aa
aa
aa
aa
aa
"}
(19,1,1) = {"
Bb
Bb
Bb
Bb
Bb
Bb
CU
Bb
Bb
Bb
Bb
Bb
Bb
aa
aa
aa
aa
ae
aa
aa
aa
aa
zb
aE
ax
ay
zb
aa
aa
aa
aa
aa
"}
(20,1,1) = {"
aa
ae
aa
aa
aa
aa
CU
aa
aa
aa
aa
ae
ae
ae
ae
ae
ae
aK
ae
ae
ae
ae
zb
aV
aV
aV
zb
aa
aa
aa
aa
aa
"}
(21,1,1) = {"
Bb
Bb
Bb
ac
Bb
ac
CU
Bb
Bb
Bb
ac
Bb
ac
aa
aa
aa
aa
aa
aa
aa
aa
aa
aa
aa
aa
aa
aa
aa
aa
aa
aa
aa
"}
(22,1,1) = {"
ac
Bb
Bb
ac
Bb
ac
CU
ac
Bb
Bb
ac
Bb
ac
aa
aa
aa
aa
aa
aa
aa
aa
aa
aa
aa
aa
aa
aa
aa
aa
aa
aa
aa
"}
(23,1,1) = {"
aa
ae
aa
aa
aa
aa
CU
aa
aa
aa
aa
ae
aa
aa
aa
aa
aa
aa
aa
aa
aa
aa
aa
aa
aa
aa
aa
aa
aa
aa
aa
aa
"}
(24,1,1) = {"
Bb
Bb
Bb
Bb
Bb
Bb
CU
Bb
Bb
Bb
Bb
Bb
Bb
aa
aa
aa
aa
aa
aa
aa
aa
aa
aa
aa
aa
aa
aa
aa
aa
aa
aa
aa
"}
(25,1,1) = {"
Bb
Bb
Bb
Bb
Bb
Bb
CU
Bb
Bb
Bb
Bb
Bb
Bb
aa
aa
aa
aa
aa
aa
aa
aa
aa
aa
aa
aa
aa
aa
aa
aa
aa
aa
aa
"}
