//MAP CONVERTED BY dmm2tgm.py THIS HEADER COMMENT PREVENTS RECONVERSION, DO NOT REMOVE
"aa" = (
/turf/template_noop,
/area/template_noop)
"ac" = (
/obj/machinery/power/solar/fake,
/obj/structure/cable,
/turf/open/floor/iron/solarpanel/airless,
/area/ruin/space/djstation/solars)
"ad" = (
/turf/template_noop,
/area/ruin/space/djstation/solars)
"ae" = (
/obj/structure/lattice,
/turf/template_noop,
/area/template_noop)
"af" = (
/turf/closed/wall,
/area/ruin/space/djstation)
"ag" = (
/obj/effect/spawner/structure/window/reinforced,
/turf/open/floor/plating,
/area/ruin/space/djstation)
"ah" = (
/turf/open/floor/plating,
/area/ruin/space/djstation)
"ai" = (
/obj/machinery/telecomms/relay/preset/ruskie,
/obj/machinery/light/directional/north,
/obj/structure/cable,
/turf/open/floor/plating,
/area/ruin/space/djstation)
"aj" = (
/obj/machinery/power/terminal,
/obj/structure/cable,
/obj/effect/mapping_helpers/smart_pipe/manifold4w/scrubbers/hidden/layer2,
/turf/open/floor/plating,
/area/ruin/space/djstation)
"ak" = (
/obj/item/multitool,
/obj/effect/decal/cleanable/dirt/dust,
/turf/open/floor/plating,
/area/ruin/space/djstation)
"al" = (
/obj/item/storage/toolbox/mechanical{
	pixel_x = -2;
	pixel_y = -1
	},
/obj/effect/decal/cleanable/dirt/dust,
/turf/open/floor/plating,
/area/ruin/space/djstation)
"am" = (
/obj/item/extinguisher,
/obj/effect/decal/cleanable/dirt/dust,
/turf/open/floor/plating,
/area/ruin/space/djstation)
"an" = (
/obj/machinery/power/smes/magical{
	desc = "A high-capacity superconducting magnetic energy storage (SMES) unit.";
	name = "power storage unit"
	},
/obj/structure/cable,
/obj/effect/decal/cleanable/dirt,
/obj/effect/mapping_helpers/smart_pipe/manifold4w/scrubbers/hidden/layer2,
/turf/open/floor/plating,
/area/ruin/space/djstation)
"ao" = (
/obj/structure/cable,
/obj/effect/decal/cleanable/dirt,
/obj/effect/mapping_helpers/smart_pipe/manifold4w/supply/hidden/layer4,
/obj/effect/mapping_helpers/smart_pipe/manifold4w/scrubbers/hidden/layer2,
/turf/open/floor/plating,
/area/ruin/space/djstation)
"ap" = (
/obj/machinery/power/apc/auto_name/south,
/obj/structure/cable,
/obj/structure/closet/crate,
/obj/effect/spawner/lootdrop/space/syndiecosmetic,
/turf/open/floor/plating,
/area/ruin/space/djstation)
"aq" = (
/obj/item/storage/box/lights/mixed,
/obj/structure/sign/warning/electricshock{
	pixel_y = -32
	},
/obj/structure/cable,
/obj/effect/decal/cleanable/dirt,
/turf/open/floor/plating,
/area/ruin/space/djstation)
"as" = (
/obj/structure/rack,
/obj/item/clothing/mask/breath,
/obj/effect/decal/cleanable/dirt/dust,
/obj/item/clothing/suit/space/orange,
/obj/item/clothing/head/helmet/space/orange,
/turf/open/floor/plating,
/area/ruin/space/djstation)
"at" = (
/obj/machinery/door/airlock/maintenance_hatch,
/obj/effect/mapping_helpers/smart_pipe/manifold4w/supply/hidden/layer4,
/obj/effect/mapping_helpers/smart_pipe/manifold4w/scrubbers/hidden/layer2,
/turf/open/floor/iron/textured,
/area/ruin/space/djstation)
"au" = (
/obj/structure/closet/emcloset,
/turf/open/floor/iron/textured,
/area/ruin/space/djstation)
"av" = (
/obj/machinery/vending/snack,
/obj/machinery/light/small/directional/north,
/turf/open/floor/iron/textured,
/area/ruin/space/djstation)
"aw" = (
/obj/effect/mapping_helpers/smart_pipe/manifold4w/supply/hidden/layer4,
/obj/effect/mapping_helpers/smart_pipe/manifold4w/scrubbers/hidden/layer2,
/turf/open/floor/iron/textured,
/area/ruin/space/djstation)
"ax" = (
/obj/machinery/light_switch/directional/north,
/obj/effect/decal/cleanable/dirt,
/turf/open/floor/iron/textured,
/area/ruin/space/djstation)
"ay" = (
/obj/machinery/newscaster/directional/north,
/obj/effect/decal/cleanable/dirt,
/turf/open/floor/iron/textured,
/area/ruin/space/djstation)
"az" = (
/obj/structure/table,
/obj/machinery/cell_charger,
/obj/effect/turf_decal/tile/bar,
/obj/effect/turf_decal/tile/bar{
	dir = 1
	},
/obj/effect/spawner/lootdrop/donkpockets,
/turf/open/floor/iron,
/area/ruin/space/djstation)
"aB" = (
/obj/effect/spawner/lootdrop/crate_spawner,
/obj/machinery/atmospherics/components/unary/vent_scrubber/on/layer2,
/turf/open/floor/iron/grimy,
/area/ruin/space/djstation)
"aC" = (
/obj/machinery/light_switch/directional/north,
/obj/effect/decal/cleanable/dirt,
/turf/open/floor/iron/grimy,
/area/ruin/space/djstation)
"aD" = (
/obj/structure/bed,
/obj/item/bedsheet,
/obj/effect/decal/cleanable/dirt,
/turf/open/floor/iron/grimy,
/area/ruin/space/djstation)
"aE" = (
/obj/structure/table,
/obj/item/flashlight/lamp,
/turf/open/floor/iron/grimy,
/area/ruin/space/djstation)
"aF" = (
/obj/structure/table,
/obj/machinery/microwave{
	pixel_y = 8
	},
/obj/effect/turf_decal/tile/bar,
/obj/effect/turf_decal/tile/bar{
	dir = 1
	},
/obj/machinery/atmospherics/components/unary/vent_pump/on/layer4{
	dir = 4
	},
/turf/open/floor/iron,
/area/ruin/space/djstation)
"aG" = (
/obj/machinery/door/airlock/public/glass{
	name = "Kitchen"
	},
/obj/effect/mapping_helpers/smart_pipe/manifold4w/supply/hidden/layer4,
/obj/effect/mapping_helpers/smart_pipe/manifold4w/scrubbers/hidden/layer2,
/turf/open/floor/iron/textured,
/area/ruin/space/djstation)
"aH" = (
/obj/structure/table,
/obj/item/radio/intercom{
	dir = 8;
	freerange = 1;
	name = "Pirate Radio Listening Channel"
	},
/obj/effect/decal/cleanable/dirt/dust,
/obj/effect/mapping_helpers/smart_pipe/manifold4w/supply/hidden/layer4,
/obj/effect/mapping_helpers/smart_pipe/manifold4w/scrubbers/hidden/layer2,
/turf/open/floor/glass/reinforced,
/area/ruin/space/djstation)
"aI" = (
/obj/structure/chair/office/light,
/obj/effect/mapping_helpers/smart_pipe/manifold4w/supply/hidden/layer4,
/obj/effect/mapping_helpers/smart_pipe/manifold4w/scrubbers/hidden/layer2,
/turf/open/floor/glass/reinforced,
/area/ruin/space/djstation)
"aJ" = (
/obj/machinery/door/airlock/public/glass{
	name = "Rest Room"
	},
/obj/effect/mapping_helpers/smart_pipe/manifold4w/supply/hidden/layer4,
/obj/effect/mapping_helpers/smart_pipe/manifold4w/scrubbers/hidden/layer2,
/turf/open/floor/iron/textured,
/area/ruin/space/djstation)
"aK" = (
/obj/effect/decal/cleanable/dirt,
/obj/effect/mapping_helpers/smart_pipe/manifold4w/supply/hidden/layer4,
/obj/effect/mapping_helpers/smart_pipe/manifold4w/scrubbers/hidden/layer2,
/turf/open/floor/iron/grimy,
/area/ruin/space/djstation)
"aL" = (
/obj/machinery/sleeper{
	dir = 8
	},
/obj/machinery/atmospherics/components/unary/vent_pump/on/layer4{
	dir = 8
	},
/turf/open/floor/iron/grimy,
/area/ruin/space/djstation)
"aM" = (
/obj/machinery/disposal/bin,
/obj/structure/disposalpipe/trunk,
/obj/effect/turf_decal/tile/bar,
/obj/effect/turf_decal/tile/bar{
	dir = 1
	},
/obj/effect/decal/cleanable/dirt/dust,
/turf/open/floor/iron,
/area/ruin/space/djstation)
"aN" = (
/obj/machinery/light/small/directional/south,
/obj/effect/turf_decal/tile/bar,
/obj/effect/turf_decal/tile/bar{
	dir = 1
	},
/obj/effect/decal/cleanable/dirt/dust,
/turf/open/floor/iron,
/area/ruin/space/djstation)
"aO" = (
/obj/effect/turf_decal/tile/bar,
/obj/effect/turf_decal/tile/bar{
	dir = 1
	},
/obj/effect/decal/cleanable/dirt/dust,
/turf/open/floor/iron,
/area/ruin/space/djstation)
"aP" = (
/obj/structure/table,
/obj/effect/spawner/lootdrop/maintenance,
/obj/effect/decal/cleanable/dirt/dust,
/turf/open/floor/glass/reinforced,
/area/ruin/space/djstation)
"aQ" = (
/obj/structure/table,
/obj/item/radio/intercom{
	broadcasting = 1;
	dir = 8;
	freerange = 1;
	listening = 0;
	name = "Pirate Radio Broadcast Channel"
	},
/turf/open/floor/glass/reinforced,
/area/ruin/space/djstation)
"aR" = (
/obj/structure/table,
/obj/item/paper/fluff/ruins/djstation,
/obj/effect/decal/cleanable/dirt/dust,
/obj/effect/mapping_helpers/smart_pipe/manifold4w/supply/hidden/layer4,
/turf/open/floor/glass/reinforced,
/area/ruin/space/djstation)
"aS" = (
/obj/structure/frame/computer{
	anchored = 1
	},
/obj/effect/decal/cleanable/dirt,
/turf/open/floor/iron/grimy,
/area/ruin/space/djstation)
"aT" = (
/obj/structure/chair{
	dir = 8
	},
/obj/effect/decal/cleanable/dirt,
/turf/open/floor/iron/grimy,
/area/ruin/space/djstation)
"aU" = (
/obj/machinery/light/small/directional/south,
/turf/open/floor/iron/grimy,
/area/ruin/space/djstation)
"aV" = (
/obj/structure/closet,
/obj/effect/spawner/lootdrop/maintenance,
/obj/effect/spawner/lootdrop/clothes,
/turf/open/floor/iron/grimy,
/area/ruin/space/djstation)
"aW" = (
/obj/structure/disposalpipe/segment,
/turf/closed/wall,
/area/ruin/space/djstation)
"aX" = (
/obj/machinery/door/airlock/hatch{
	name = "Washroom"
	},
/turf/open/floor/iron/freezer,
/area/ruin/space/djstation)
"aY" = (
/obj/machinery/light/directional/east,
/obj/effect/decal/cleanable/dirt/dust,
/turf/open/floor/iron/textured,
/area/ruin/space/djstation)
"aZ" = (
/obj/structure/disposalpipe/segment,
/turf/open/floor/plating/airless,
/area/template_noop)
"ba" = (
/obj/effect/decal/cleanable/dirt/dust,
/turf/open/floor/iron/freezer,
/area/ruin/space/djstation)
"bb" = (
/obj/structure/chair{
	dir = 4
	},
/turf/open/floor/iron/textured,
/area/ruin/space/djstation)
"bc" = (
/obj/structure/window/reinforced{
	dir = 1
	},
/obj/machinery/space_heater,
/turf/open/floor/iron/textured,
/area/ruin/space/djstation)
"bd" = (
/obj/structure/window/reinforced{
	dir = 1
	},
/obj/structure/rack,
/obj/item/clothing/under/costume/soviet,
/obj/item/clothing/head/ushanka,
/obj/effect/decal/cleanable/dirt/dust,
/turf/open/floor/iron/textured,
/area/ruin/space/djstation)
"be" = (
/obj/structure/sink{
	dir = 4;
	pixel_x = -12;
	pixel_y = 2
	},
/obj/machinery/light/small/directional/south,
/obj/effect/decal/cleanable/dirt/dust,
/turf/open/floor/iron/freezer,
/area/ruin/space/djstation)
"bf" = (
/obj/structure/toilet{
	pixel_y = 8
	},
/turf/open/floor/iron/freezer,
/area/ruin/space/djstation)
"bg" = (
/obj/structure/table,
/obj/item/paper_bin{
	pixel_x = 1;
	pixel_y = 9
	},
/obj/item/pen,
/turf/open/floor/iron/textured,
/area/ruin/space/djstation)
"bh" = (
/obj/structure/sign/warning/vacuum/external{
	pixel_y = -32
	},
/obj/effect/decal/cleanable/dirt,
/turf/open/floor/iron/textured,
/area/ruin/space/djstation)
"bi" = (
/obj/machinery/door/airlock/external{
	name = "Ruskie DJ Station"
	},
/obj/effect/mapping_helpers/airlock/cyclelink_helper,
/obj/effect/decal/cleanable/dirt,
/turf/open/floor/plating,
/area/ruin/space/djstation)
"bj" = (
/obj/structure/disposalpipe/trunk{
	dir = 1
	},
/obj/structure/disposaloutlet,
/turf/open/floor/plating/airless,
/area/template_noop)
"cp" = (
/obj/structure/cable,
/obj/effect/decal/cleanable/dirt/dust,
/obj/machinery/atmospherics/components/binary/pump/layer2{
	dir = 8
	},
/turf/open/floor/plating,
/area/ruin/space/djstation)
"cN" = (
/obj/effect/decal/cleanable/dirt,
/obj/effect/mapping_helpers/smart_pipe/manifold4w/supply/hidden/layer4,
/obj/effect/mapping_helpers/smart_pipe/manifold4w/scrubbers/hidden/layer2,
/turf/open/floor/iron/textured,
/area/ruin/space/djstation)
"jz" = (
/obj/effect/turf_decal/tile/bar,
/obj/effect/turf_decal/tile/bar{
	dir = 1
	},
/obj/effect/decal/cleanable/dirt/dust,
/obj/effect/mapping_helpers/smart_pipe/manifold4w/supply/hidden/layer4,
/obj/effect/mapping_helpers/smart_pipe/manifold4w/scrubbers/hidden/layer2,
/turf/open/floor/iron,
/area/ruin/space/djstation)
"lq" = (
/obj/effect/decal/cleanable/dirt,
/turf/open/floor/plating,
/area/ruin/space/djstation)
"mR" = (
/obj/effect/decal/cleanable/dirt/dust,
/obj/machinery/atmospherics/components/unary/vent_pump/on/layer4{
	dir = 1
	},
/turf/open/floor/iron/textured,
/area/ruin/space/djstation)
"oM" = (
/obj/effect/decal/cleanable/dirt,
/turf/open/floor/iron/textured,
/area/ruin/space/djstation)
"oV" = (
/obj/effect/decal/cleanable/dirt/dust,
/obj/item/mop,
/obj/item/reagent_containers/glass/bucket,
/obj/structure/reagent_dispensers/watertank,
/turf/open/floor/plating,
/area/ruin/space/djstation)
"rh" = (
/obj/structure/cable,
/obj/machinery/power/tracker,
/turf/open/floor/iron/solarpanel/airless,
/area/ruin/space/djstation/solars)
"rw" = (
/obj/machinery/atmospherics/components/unary/portables_connector/layer4{
	dir = 4
	},
/obj/machinery/portable_atmospherics/canister/air,
/turf/open/floor/plating,
/area/ruin/space/djstation)
"td" = (
/obj/machinery/atmospherics/components/unary/vent_pump/on/layer4{
	dir = 8
	},
/turf/open/floor/plating,
/area/ruin/space/djstation)
"ts" = (
/obj/structure/cable,
/obj/effect/decal/cleanable/dirt/dust,
/obj/machinery/atmospherics/components/unary/vent_scrubber/on/layer2{
	dir = 4
	},
/turf/open/floor/plating,
/area/ruin/space/djstation)
"uk" = (
/obj/effect/turf_decal/tile/bar,
/obj/effect/turf_decal/tile/bar{
	dir = 1
	},
/obj/effect/decal/cleanable/dirt/dust,
/obj/effect/mapping_helpers/smart_pipe/manifold4w/supply/hidden/layer4,
/turf/open/floor/iron,
/area/ruin/space/djstation)
"yY" = (
/obj/effect/decal/cleanable/dirt/dust,
/obj/effect/mapping_helpers/smart_pipe/manifold4w/scrubbers/hidden/layer2,
/turf/open/floor/plating,
/area/ruin/space/djstation)
"zL" = (
/obj/structure/cable,
/obj/effect/mapping_helpers/smart_pipe/manifold4w/supply/hidden/layer4,
/obj/effect/mapping_helpers/smart_pipe/manifold4w/scrubbers/hidden/layer2,
/turf/open/floor/plating,
/area/ruin/space/djstation)
"zO" = (
/obj/effect/decal/cleanable/dirt/dust,
/obj/machinery/atmospherics/components/unary/vent_scrubber/on/layer2,
/turf/open/floor/iron/textured,
/area/ruin/space/djstation)
"Au" = (
/obj/machinery/airalarm/directional/south,
/turf/open/floor/plating,
/area/ruin/space/djstation)
"Bb" = (
/obj/machinery/power/solar/fake,
/obj/structure/cable,
/obj/effect/decal/cleanable/dirt,
/turf/open/floor/iron/solarpanel/airless,
/area/ruin/space/djstation/solars)
"BY" = (
/obj/effect/decal/cleanable/dirt,
/obj/effect/mapping_helpers/smart_pipe/manifold4w/supply/hidden/layer4,
/turf/open/floor/plating,
/area/ruin/space/djstation)
"Co" = (
/obj/machinery/door/airlock/external{
	name = "Ruskie DJ Station"
	},
/obj/effect/mapping_helpers/airlock/cyclelink_helper{
	dir = 1
	},
/turf/open/floor/plating,
/area/ruin/space/djstation)
"Fc" = (
/obj/structure/cable,
/obj/effect/decal/cleanable/dirt,
/turf/open/floor/plating/airless,
/area/ruin/space/djstation/solars)
"IW" = (
/obj/effect/spawner/structure/window/reinforced,
/obj/structure/cable,
/turf/open/floor/plating,
/area/ruin/space/djstation)
"KS" = (
/obj/structure/cable,
/obj/effect/decal/cleanable/dirt,
/turf/open/floor/plating,
/area/ruin/space/djstation)
"KU" = (
/turf/open/floor/iron/textured,
/area/ruin/space/djstation)
"Lm" = (
/obj/effect/turf_decal/tile/bar,
/obj/effect/turf_decal/tile/bar{
	dir = 1
	},
/obj/machinery/atmospherics/components/unary/vent_scrubber/on/layer2,
/obj/effect/decal/cleanable/dirt/dust,
/turf/open/floor/iron,
/area/ruin/space/djstation)
"NH" = (
/obj/structure/cable,
/turf/open/floor/plating,
/area/ruin/space/djstation)
"Py" = (
/obj/effect/decal/cleanable/dirt/dust,
/obj/machinery/atmospherics/components/unary/portables_connector/layer2{
	dir = 4
	},
/obj/machinery/portable_atmospherics/canister,
/turf/open/floor/plating,
/area/ruin/space/djstation)
"QM" = (
/obj/structure/cable,
/obj/effect/spawner/lootdrop/maintenance,
/obj/effect/spawner/lootdrop/maintenance,
/obj/effect/decal/cleanable/dirt,
/turf/open/floor/plating,
/area/ruin/space/djstation)
"Vk" = (
/obj/machinery/power/solar_control,
/obj/structure/cable,
/turf/open/floor/plating,
/area/ruin/space/djstation)
"VR" = (
/obj/effect/decal/cleanable/dirt/dust,
/obj/effect/mapping_helpers/smart_pipe/manifold4w/supply/hidden/layer4,
/obj/effect/mapping_helpers/smart_pipe/manifold4w/scrubbers/hidden/layer2,
/turf/open/floor/iron/textured,
/area/ruin/space/djstation)
"Yn" = (
/obj/effect/decal/cleanable/dirt/dust,
/turf/open/floor/iron/textured,
/area/ruin/space/djstation)
"Zh" = (
/obj/structure/cable,
/turf/open/floor/plating/airless,
/area/ruin/space/djstation/solars)
"ZF" = (
/obj/effect/decal/cleanable/dirt/dust,
/turf/open/floor/plating,
/area/ruin/space/djstation)
"ZG" = (
/obj/effect/decal/cleanable/dirt,
/obj/effect/mapping_helpers/smart_pipe/manifold4w/supply/hidden/layer4,
/turf/open/floor/iron/grimy,
/area/ruin/space/djstation)

(1,1,1) = {"
ad
ad
ad
ad
ad
ad
ad
aa
af
ag
ag
ag
af
aa
ae
aa
aa
aa
"}
(2,1,1) = {"
ad
ac
ad
ac
ad
ac
ad
aa
af
az
aF
aM
aW
aZ
aZ
aZ
bj
aa
"}
(3,1,1) = {"
ad
ac
ad
ac
ad
ac
ad
aa
af
aO
uk
aN
af
ae
ae
aa
aa
aa
"}
(4,1,1) = {"
ad
ac
ad
ac
ad
ac
ad
aa
af
aO
uk
aO
af
af
af
af
aa
aa
"}
(5,1,1) = {"
ad
ac
Zh
ac
Zh
ac
ad
aa
af
Lm
jz
aO
aX
ba
be
af
aa
aa
"}
(6,1,1) = {"
af
IW
ag
af
ag
ag
af
af
af
ag
aG
ag
af
af
bf
af
aa
aa
"}
(7,1,1) = {"
ag
NH
ZF
Py
am
rw
ap
af
au
oM
cN
Yn
Yn
af
af
af
aa
aa
"}
(8,1,1) = {"
ag
Vk
ts
cp
ah
BY
aq
af
av
zO
aH
aP
KU
bb
bg
af
aa
aa
"}
(9,1,1) = {"
af
ai
yY
aj
an
ao
zL
at
aw
VR
aI
aQ
KU
oM
oM
af
aa
aa
"}
(10,1,1) = {"
ag
KS
ZF
ak
lq
td
Au
af
ax
Yn
aH
aR
mR
bc
bh
af
af
af
"}
(11,1,1) = {"
ag
QM
ah
al
ZF
oV
as
af
ay
KU
aw
KU
aY
bd
oM
bi
lq
Co
"}
(12,1,1) = {"
af
IW
ag
af
ag
ag
af
af
af
ag
aJ
ag
af
af
af
af
af
af
"}
(13,1,1) = {"
ad
ac
Fc
Bb
Fc
ac
ad
aa
af
aB
aK
aS
af
aa
aa
aa
aa
aa
"}
(14,1,1) = {"
ad
ac
ad
ac
ad
ac
ad
aa
af
aC
ZG
aT
af
aa
aa
aa
aa
aa
"}
(15,1,1) = {"
ad
ac
ad
Bb
ad
ac
ad
aa
af
aD
ZG
aU
af
ae
ae
aa
aa
aa
"}
(16,1,1) = {"
ad
ac
ad
rh
ad
ac
ad
aa
af
aE
aL
aV
af
aa
aa
aa
aa
aa
"}
(17,1,1) = {"
ad
ad
ad
ad
ad
ad
ad
aa
af
ag
ag
ag
af
aa
aa
aa
aa
aa
"}
