//MAP CONVERTED BY dmm2tgm.py THIS HEADER COMMENT PREVENTS RECONVERSION, DO NOT REMOVE
"aa" = (
/turf/template_noop,
/area/template_noop)
"ac" = (
/obj/machinery/power/solar/fake,
/obj/structure/cable,
/turf/open/floor/iron/solarpanel/airless,
/area/ruin/space/djstation/solars)
"ae" = (
/obj/structure/lattice,
/turf/template_noop,
/area/template_noop)
"af" = (
/turf/closed/wall,
/area/ruin/space/djstation)
"ag" = (
/obj/structure/window/shuttle/survival_pod,
/obj/structure/grille,
/obj/structure/low_wall,
/turf/open/floor/plating,
/area/ruin/space/djstation)
"ah" = (
/obj/structure/cable,
/obj/effect/decal/cleanable/dirt/dust,
/obj/machinery/power/terminal{
	dir = 1
	},
/obj/structure/lattice/catwalk/plated/textured,
/turf/open/floor/plating,
/area/ruin/space/djstation)
"aj" = (
/obj/effect/decal/cleanable/dirt,
/obj/machinery/atmospherics/components/unary/vent_pump/on/layer4{
	dir = 4
	},
/turf/open/floor/plating,
/area/ruin/space/djstation)
"ak" = (
/obj/effect/decal/cleanable/dirt,
/obj/effect/mapping_helpers/smart_pipe/manifold4w/supply/hidden/layer4,
/obj/machinery/atmospherics/components/unary/portables_connector/layer2,
/obj/machinery/portable_atmospherics/canister,
/turf/open/floor/plating,
/area/ruin/space/djstation)
"am" = (
/obj/structure/cable,
/obj/machinery/door/airlock/external/glass{
	dir = 4
	},
/obj/machinery/door/poddoor/shutters/preopen{
	id = "djstationengineering";
	dir = 4
	},
/turf/open/floor/plating,
/area/ruin/space/djstation)
"ao" = (
/obj/effect/decal/cleanable/dirt,
/obj/machinery/atmospherics/components/unary/vent_scrubber/on/layer2,
/turf/open/floor/plating,
/area/ruin/space/djstation)
"ap" = (
/obj/structure/window/shuttle/survival_pod,
/obj/structure/grille,
/obj/structure/low_wall,
/obj/machinery/door/poddoor/shutters/preopen{
	id = "djstationengineering";
	dir = 4
	},
/turf/open/floor/plating,
/area/ruin/space/djstation)
"aq" = (
/obj/effect/decal/cleanable/dirt,
/obj/machinery/button/door/directional/south{
	id = "djstationengineering"
	},
/obj/structure/rack,
/obj/item/multitool,
/obj/item/storage/toolbox/mechanical{
	pixel_x = -2;
	pixel_y = -1
	},
/turf/open/floor/plating,
/area/ruin/space/djstation)
"at" = (
/obj/machinery/door/airlock/maintenance_hatch,
/obj/effect/mapping_helpers/smart_pipe/manifold4w/supply/hidden/layer4,
/obj/effect/mapping_helpers/smart_pipe/manifold4w/scrubbers/hidden/layer2,
/turf/open/floor/iron/textured,
/area/ruin/space/djstation)
"au" = (
/obj/structure/closet/emcloset,
/obj/effect/mapping_helpers/smart_pipe/manifold4w/supply/hidden/layer4,
/obj/effect/mapping_helpers/smart_pipe/manifold4w/scrubbers/hidden/layer2,
/turf/open/floor/iron/textured,
/area/ruin/space/djstation)
"av" = (
/obj/machinery/light/small/directional/north,
/obj/effect/mapping_helpers/smart_pipe/manifold4w/supply/hidden/layer4,
/obj/effect/mapping_helpers/smart_pipe/manifold4w/scrubbers/hidden/layer2,
/obj/effect/spawner/lootdrop/crate_spawner,
/obj/effect/spawner/lootdrop/maintenance,
/obj/effect/spawner/lootdrop/maintenance,
/turf/open/floor/iron/textured,
/area/ruin/space/djstation)
"aw" = (
/obj/effect/mapping_helpers/smart_pipe/manifold4w/supply/hidden/layer4,
/obj/effect/mapping_helpers/smart_pipe/manifold4w/scrubbers/hidden/layer2,
/turf/open/floor/iron/textured,
/area/ruin/space/djstation)
"ax" = (
/obj/machinery/light_switch/directional/north,
/obj/effect/decal/cleanable/dirt,
/obj/effect/mapping_helpers/smart_pipe/manifold4w/supply/hidden/layer4,
/obj/effect/mapping_helpers/smart_pipe/manifold4w/scrubbers/hidden/layer2,
/obj/machinery/newscaster/directional/north,
/obj/effect/spawner/lootdrop/space/syndiecosmetic,
/obj/structure/closet/crate,
/turf/open/floor/iron/textured,
/area/ruin/space/djstation)
"ay" = (
/obj/effect/decal/cleanable/dirt,
/obj/effect/mapping_helpers/smart_pipe/manifold4w/supply/hidden/layer4,
/obj/effect/mapping_helpers/smart_pipe/manifold4w/scrubbers/hidden/layer2,
/obj/machinery/telecomms/relay/preset/ruskie{
	pixel_y = 16;
	layer = 3.01
	},
/turf/open/floor/iron/textured,
/area/ruin/space/djstation)
"az" = (
/obj/structure/table,
/obj/effect/turf_decal/tile/bar,
/obj/effect/turf_decal/tile/bar{
	dir = 1
	},
/obj/machinery/microwave{
	pixel_y = 8
	},
/turf/open/floor/iron,
/area/ruin/space/djstation)
"aB" = (
/obj/machinery/sleeper,
/turf/open/floor/iron/grimy,
/area/ruin/space/djstation)
"aC" = (
/obj/machinery/light_switch/directional/north,
/obj/effect/decal/cleanable/dirt,
/obj/structure/closet,
/obj/effect/spawner/lootdrop/clothes,
/obj/effect/spawner/lootdrop/maintenance,
/turf/open/floor/iron/grimy,
/area/ruin/space/djstation)
"aD" = (
/obj/effect/decal/cleanable/dirt,
/obj/item/flashlight/lamp{
	pixel_y = 14
	},
/obj/structure/table,
/obj/item/paper_bin{
	pixel_x = 16;
	pixel_y = 9
	},
/obj/item/pen,
/turf/open/floor/iron/grimy,
/area/ruin/space/djstation)
"aE" = (
/obj/structure/table,
/turf/open/floor/iron/grimy,
/area/ruin/space/djstation)
"aF" = (
/obj/effect/turf_decal/tile/bar,
/obj/effect/turf_decal/tile/bar{
	dir = 1
	},
/turf/open/floor/iron,
/area/ruin/space/djstation)
"aG" = (
/obj/machinery/door/airlock/public/glass{
	name = "Kitchen";
	dir = 4
	},
/obj/effect/mapping_helpers/smart_pipe/manifold4w/supply/hidden/layer4,
/obj/effect/mapping_helpers/smart_pipe/manifold4w/scrubbers/hidden/layer2,
/turf/open/floor/iron/textured,
/area/ruin/space/djstation)
"aH" = (
/obj/item/radio/intercom{
	dir = 8;
	freerange = 1;
	name = "Pirate Radio Listening Channel"
	},
/obj/effect/decal/cleanable/dirt/dust,
/obj/structure/table/reinforced/plastitaniumglass,
/turf/open/floor/plating,
/area/ruin/space/djstation)
"aI" = (
/obj/structure/chair/office/light,
/turf/open/floor/plating,
/area/ruin/space/djstation)
"aJ" = (
/obj/machinery/door/airlock/public/glass{
	name = "Rest Room";
	dir = 4
	},
/obj/effect/mapping_helpers/smart_pipe/manifold4w/supply/hidden/layer4,
/obj/effect/mapping_helpers/smart_pipe/manifold4w/scrubbers/hidden/layer2,
/turf/open/floor/iron/textured,
/area/ruin/space/djstation)
"aK" = (
/obj/effect/decal/cleanable/dirt,
/obj/effect/mapping_helpers/smart_pipe/manifold4w/supply/hidden/layer4,
/obj/effect/mapping_helpers/smart_pipe/manifold4w/scrubbers/hidden/layer2,
/turf/open/floor/iron/grimy,
/area/ruin/space/djstation)
"aL" = (
/obj/structure/chair/office/light{
	dir = 1
	},
/turf/open/floor/iron/grimy,
/area/ruin/space/djstation)
"aM" = (
/obj/machinery/disposal/bin,
/obj/structure/disposalpipe/trunk,
/obj/effect/turf_decal/tile/bar,
/obj/effect/turf_decal/tile/bar{
	dir = 1
	},
/obj/effect/decal/cleanable/dirt/dust,
/turf/open/floor/iron,
/area/ruin/space/djstation)
"aN" = (
/obj/machinery/light/small/directional/south,
/obj/effect/turf_decal/tile/bar,
/obj/effect/turf_decal/tile/bar{
	dir = 1
	},
/obj/effect/decal/cleanable/dirt/dust,
/turf/open/floor/iron,
/area/ruin/space/djstation)
"aO" = (
/obj/effect/turf_decal/tile/bar,
/obj/effect/turf_decal/tile/bar{
	dir = 1
	},
/obj/effect/decal/cleanable/dirt/dust,
/turf/open/floor/iron,
/area/ruin/space/djstation)
"aP" = (
/obj/effect/spawner/lootdrop/maintenance,
/obj/effect/decal/cleanable/dirt/dust,
/obj/structure/table/reinforced/plastitaniumglass,
/turf/open/floor/plating,
/area/ruin/space/djstation)
"aQ" = (
/obj/item/radio/intercom{
	broadcasting = 1;
	dir = 8;
	freerange = 1;
	listening = 0;
	name = "Pirate Radio Broadcast Channel"
	},
/obj/structure/table/reinforced/plastitaniumglass,
/turf/open/floor/plating,
/area/ruin/space/djstation)
"aR" = (
/obj/item/paper/fluff/ruins/djstation,
/obj/effect/decal/cleanable/dirt/dust,
/obj/structure/table/reinforced/plastitaniumglass,
/turf/open/floor/plating,
/area/ruin/space/djstation)
"aS" = (
/obj/effect/decal/cleanable/dirt,
/obj/structure/bed,
/obj/item/bedsheet,
/turf/open/floor/iron/grimy,
/area/ruin/space/djstation)
"aT" = (
/obj/effect/decal/cleanable/dirt,
/turf/open/floor/iron/grimy,
/area/ruin/space/djstation)
"aU" = (
/obj/machinery/light/small/directional/south,
/turf/open/floor/iron/grimy,
/area/ruin/space/djstation)
"aV" = (
/turf/open/floor/iron/grimy,
/area/ruin/space/djstation)
"aW" = (
/obj/structure/disposalpipe/segment,
/obj/effect/mapping_helpers/paint_wall/skyline/inner_hull/cook,
/turf/closed/wall,
/area/ruin/space/djstation)
"aX" = (
/obj/machinery/door/airlock/hatch{
	name = "Washroom"
	},
/turf/open/floor/iron/freezer,
/area/ruin/space/djstation)
"aY" = (
/obj/machinery/light/directional/east,
/obj/effect/decal/cleanable/dirt/dust,
/turf/open/floor/iron/textured,
/area/ruin/space/djstation)
"aZ" = (
/obj/structure/disposalpipe/segment,
/obj/structure/lattice,
/turf/template_noop,
/area/template_noop)
"bb" = (
/obj/item/clothing/suit/space/orange,
/obj/item/clothing/mask/breath,
/obj/structure/rack,
/obj/item/clothing/head/helmet/space/orange,
/obj/structure/window/reinforced{
	dir = 1
	},
/turf/open/floor/iron/textured,
/area/ruin/space/djstation)
"be" = (
/obj/structure/sink{
	dir = 4;
	pixel_x = -12;
	pixel_y = 2
	},
/obj/machinery/light/small/directional/south,
/obj/effect/decal/cleanable/dirt/dust,
/turf/open/floor/iron/freezer,
/area/ruin/space/djstation)
"bf" = (
/obj/structure/toilet{
	pixel_y = 8
	},
/turf/open/floor/iron/freezer,
/area/ruin/space/djstation)
"bg" = (
/obj/structure/sign/warning/vacuum/external{
	pixel_y = -32
	},
/obj/effect/decal/cleanable/dirt,
/obj/item/clothing/head/ushanka,
/obj/item/clothing/under/costume/soviet,
/obj/structure/rack,
/obj/effect/turf_decal/stripes/asteroid/line,
/turf/open/floor/iron/textured,
/area/ruin/space/djstation)
"bi" = (
/obj/machinery/door/airlock/external{
	name = "Ruskie DJ Station"
	},
/obj/effect/mapping_helpers/airlock/cyclelink_helper,
/obj/effect/decal/cleanable/dirt,
/turf/open/floor/plating,
/area/ruin/space/djstation)
"bj" = (
/obj/structure/disposalpipe/trunk{
	dir = 1
	},
/obj/structure/disposaloutlet,
/turf/template_noop,
/area/template_noop)
"cp" = (
/obj/machinery/power/smes/magical{
	desc = "A high-capacity superconducting magnetic energy storage (SMES) unit.";
	name = "power storage unit"
	},
/obj/structure/cable,
/turf/open/floor/plating,
/area/ruin/space/djstation)
"ct" = (
/obj/effect/turf_decal/tile/bar,
/obj/effect/turf_decal/tile/bar{
	dir = 1
	},
/obj/effect/decal/cleanable/dirt/dust,
/obj/effect/mapping_helpers/smart_pipe/manifold4w/supply/hidden/layer4,
/obj/machinery/atmospherics/components/unary/vent_scrubber/on/layer2{
	dir = 4
	},
/turf/open/floor/iron,
/area/ruin/space/djstation)
"cN" = (
/obj/effect/decal/cleanable/dirt,
/obj/effect/mapping_helpers/smart_pipe/manifold4w/supply/hidden/layer4,
/obj/effect/mapping_helpers/smart_pipe/manifold4w/scrubbers/hidden/layer2,
/turf/open/floor/iron/textured,
/area/ruin/space/djstation)
"fj" = (
/obj/effect/mapping_helpers/smart_pipe/manifold4w/supply/hidden/layer4,
/obj/machinery/atmospherics/components/binary/pump/layer2{
	dir = 1
	},
/obj/structure/lattice/catwalk/plated/textured,
/obj/structure/cable,
/turf/open/floor/plating,
/area/ruin/space/djstation)
"hk" = (
/obj/machinery/computer/security/telescreen/entertainment/directional/south,
/turf/open/floor/iron/textured,
/area/ruin/space/djstation)
"hy" = (
/obj/machinery/atmospherics/components/unary/vent_pump/on/layer4{
	dir = 1
	},
/turf/open/floor/iron/textured,
/area/ruin/space/djstation)
"jz" = (
/obj/effect/turf_decal/tile/bar,
/obj/effect/turf_decal/tile/bar{
	dir = 1
	},
/obj/effect/decal/cleanable/dirt/dust,
/obj/effect/mapping_helpers/smart_pipe/manifold4w/supply/hidden/layer4,
/obj/effect/mapping_helpers/smart_pipe/manifold4w/scrubbers/hidden/layer2,
/turf/open/floor/iron,
/area/ruin/space/djstation)
"lq" = (
/obj/effect/decal/cleanable/dirt,
/turf/open/floor/plating,
/area/ruin/space/djstation)
"nx" = (
/obj/effect/mapping_helpers/paint_wall/skyline/inner_hull/cook,
/obj/effect/mapping_helpers/paint_wall/skyline/inner_hull/cook,
/turf/closed/wall,
/area/ruin/space/djstation)
"rh" = (
/obj/structure/cable,
/obj/machinery/power/tracker,
/turf/open/floor/iron/solarpanel/airless,
/area/ruin/space/djstation/solars)
"ru" = (
/obj/effect/turf_decal/stripes/asteroid/line,
/turf/open/floor/iron/textured,
/area/ruin/space/djstation)
"td" = (
/obj/effect/decal/cleanable/dirt/dust,
/obj/effect/mapping_helpers/smart_pipe/manifold4w/supply/hidden/layer4,
/obj/effect/mapping_helpers/smart_pipe/manifold4w/scrubbers/hidden/layer2,
/obj/machinery/cell_charger{
	layer = 3.01
	},
/obj/structure/table,
/turf/open/floor/plating,
/area/ruin/space/djstation)
"ts" = (
/obj/structure/cable,
/obj/machinery/power/solar_control{
	dir = 4
	},
/turf/open/floor/plating,
/area/ruin/space/djstation)
"uk" = (
/obj/effect/turf_decal/tile/bar,
/obj/effect/turf_decal/tile/bar{
	dir = 1
	},
/obj/effect/decal/cleanable/dirt/dust,
/obj/machinery/atmospherics/components/unary/vent_pump/on/layer4{
	dir = 4
	},
/turf/open/floor/iron,
/area/ruin/space/djstation)
"yY" = (
/obj/machinery/light/directional/north,
/obj/structure/cable,
/obj/machinery/power/apc/auto_name/north,
/turf/open/floor/plating,
/area/ruin/space/djstation)
"zb" = (
/obj/effect/mapping_helpers/paint_wall/skyline/inner_hull/cook,
/turf/closed/wall,
/area/ruin/space/djstation)
"zL" = (
/obj/effect/mapping_helpers/smart_pipe/manifold4w/supply/hidden/layer4,
/obj/effect/mapping_helpers/smart_pipe/manifold4w/scrubbers/hidden/layer2,
/turf/open/floor/plating,
/area/ruin/space/djstation)
"Au" = (
/obj/machinery/space_heater{
	pixel_y = 16;
	layer = 3.1;
	pixel_x = 9
	},
/obj/structure/tank_holder/extinguisher/advanced{
	layer = 3.11;
	pixel_x = 8
	},
/obj/effect/mapping_helpers/smart_pipe/manifold4w/supply/hidden/layer4,
/obj/effect/mapping_helpers/smart_pipe/manifold4w/scrubbers/hidden/layer2,
/turf/open/floor/plating,
/area/ruin/space/djstation)
"Bb" = (
/obj/machinery/power/solar/fake,
/obj/structure/cable,
/obj/effect/decal/cleanable/dirt,
/turf/open/floor/iron/solarpanel/airless,
/area/ruin/space/djstation/solars)
"BH" = (
/obj/structure/disposalpipe/segment,
/turf/template_noop,
/area/template_noop)
"BY" = (
/obj/effect/decal/cleanable/dirt,
/obj/structure/rack,
/obj/item/storage/box/lights/mixed,
/turf/open/floor/plating,
/area/ruin/space/djstation)
"Co" = (
/obj/machinery/door/airlock/external{
	name = "Ruskie DJ Station"
	},
/obj/effect/mapping_helpers/airlock/cyclelink_helper{
	dir = 1
	},
/turf/open/floor/plating,
/area/ruin/space/djstation)
"CM" = (
/obj/effect/decal/cleanable/dirt,
/obj/machinery/atmospherics/components/unary/vent_pump/on/layer4{
	dir = 8
	},
/turf/open/floor/iron/grimy,
/area/ruin/space/djstation)
"CU" = (
/obj/structure/cable,
/obj/effect/decal/cleanable/dirt,
/obj/structure/lattice/catwalk/plated/dark,
/turf/open/floor/plating/airless,
/area/ruin/space/djstation/solars)
"Dg" = (
/obj/effect/mapping_helpers/paint_wall/skyline/inner_hull/cook,
/turf/closed/wall,
/area/template_noop)
"KA" = (
/obj/effect/decal/cleanable/dirt/dust,
/obj/item/mop,
/obj/item/reagent_containers/glass/bucket,
/obj/structure/reagent_dispensers/watertank,
/turf/open/floor/iron/freezer,
/area/ruin/space/djstation)
"KU" = (
/turf/open/floor/iron/textured,
/area/ruin/space/djstation)
"Lm" = (
/obj/effect/turf_decal/tile/bar,
/obj/effect/turf_decal/tile/bar{
	dir = 1
	},
/obj/effect/decal/cleanable/dirt/dust,
/obj/machinery/vending/snack,
/turf/open/floor/iron,
/area/ruin/space/djstation)
"ME" = (
/obj/effect/turf_decal/tile/bar,
/obj/effect/turf_decal/tile/bar{
	dir = 1
	},
/obj/effect/decal/cleanable/dirt/dust,
/obj/structure/table,
/obj/effect/spawner/lootdrop/donkpockets,
/turf/open/floor/iron,
/area/ruin/space/djstation)
"NH" = (
/obj/structure/cable,
/turf/open/floor/plating,
/area/ruin/space/djstation)
"OW" = (
/obj/effect/turf_decal/tile/bar,
/obj/effect/turf_decal/tile/bar{
	dir = 1
	},
/obj/effect/decal/cleanable/dirt/dust,
/obj/structure/table,
/turf/open/floor/iron,
/area/ruin/space/djstation)
"Qt" = (
/obj/effect/decal/cleanable/dirt/dust,
/obj/machinery/atmospherics/components/unary/vent_scrubber/on/layer2{
	dir = 1
	},
/turf/open/floor/iron/textured,
/area/ruin/space/djstation)
"Vk" = (
/obj/structure/window/shuttle/survival_pod,
/obj/structure/grille,
/obj/structure/low_wall,
/obj/machinery/door/poddoor/shutters/preopen{
	id = "djstationengineering"
	},
/turf/open/floor/plating,
/area/ruin/space/djstation)
"Vq" = (
/obj/effect/turf_decal/tile/bar,
/obj/effect/turf_decal/tile/bar{
	dir = 1
	},
/obj/effect/decal/cleanable/dirt/dust,
/obj/structure/table/rolling,
/obj/item/storage/bag/tray/cafeteria{
	pixel_y = 7;
	pixel_x = -1
	},
/turf/open/floor/iron,
/area/ruin/space/djstation)
"Yn" = (
/obj/effect/decal/cleanable/dirt/dust,
/turf/open/floor/iron/textured,
/area/ruin/space/djstation)
"Zh" = (
/obj/structure/cable,
/obj/structure/lattice/catwalk/plated/dark,
/turf/open/floor/plating/airless,
/area/ruin/space/djstation/solars)
"ZF" = (
/obj/effect/decal/cleanable/dirt,
/obj/machinery/portable_atmospherics/canister/air,
/obj/machinery/atmospherics/components/unary/portables_connector/layer4,
/turf/open/floor/plating,
/area/ruin/space/djstation)
"ZG" = (
/obj/effect/decal/cleanable/dirt,
/obj/effect/mapping_helpers/smart_pipe/manifold4w/supply/hidden/layer4,
/obj/machinery/atmospherics/components/unary/vent_scrubber/on/layer2{
	dir = 8
	},
/turf/open/floor/iron/grimy,
/area/ruin/space/djstation)

(1,1,1) = {"
aa
ac
aa
ac
aa
ac
aa
aa
zb
ag
ag
ag
zb
aa
aa
aa
aa
aa
"}
(2,1,1) = {"
Bb
ac
Bb
ac
Bb
ac
Bb
aa
zb
az
aF
aM
aW
BH
BH
aZ
bj
aa
"}
(3,1,1) = {"
aa
ac
aa
ac
aa
ac
aa
aa
zb
ME
uk
aN
zb
aa
aa
ae
aa
aa
"}
(4,1,1) = {"
Bb
ac
Bb
ac
Bb
ac
Bb
aa
zb
OW
ct
aO
zb
aa
aa
ae
aa
aa
"}
(5,1,1) = {"
aa
ac
aa
ac
Zh
ac
aa
aa
zb
Lm
jz
Vq
zb
aa
aa
ae
aa
aa
"}
(6,1,1) = {"
aa
aa
aa
aa
Zh
aa
aa
zb
zb
ag
aG
ag
zb
zb
zb
zb
zb
zb
"}
(7,1,1) = {"
aa
af
ap
ap
am
ap
ap
nx
au
cN
cN
Qt
Yn
KU
ru
bi
lq
Co
"}
(8,1,1) = {"
aa
Vk
ts
cp
ah
BY
aq
zb
av
Yn
aH
aP
KU
bb
bg
zb
zb
zb
"}
(9,1,1) = {"
aa
zb
yY
aj
NH
ao
zL
at
aw
Yn
aI
aQ
hk
zb
zb
zb
aa
aa
"}
(10,1,1) = {"
aa
Vk
ZF
ak
fj
td
Au
zb
ax
Yn
aH
aR
Yn
aX
be
zb
aa
aa
"}
(11,1,1) = {"
aa
af
ap
ap
am
ap
ap
zb
ay
aw
aw
hy
aY
zb
bf
zb
aa
aa
"}
(12,1,1) = {"
aa
aa
aa
aa
CU
aa
aa
zb
zb
ag
aJ
ag
zb
zb
KA
zb
aa
aa
"}
(13,1,1) = {"
aa
ac
aa
Bb
CU
ac
aa
aa
zb
aB
aK
aS
zb
Dg
Dg
Dg
aa
aa
"}
(14,1,1) = {"
Bb
ac
Bb
ac
Bb
ac
Bb
aa
zb
aC
ZG
aT
zb
aa
aa
aa
aa
aa
"}
(15,1,1) = {"
aa
ac
aa
Bb
aa
ac
aa
aa
zb
aD
CM
aU
zb
aa
aa
aa
aa
aa
"}
(16,1,1) = {"
Bb
ac
Bb
rh
Bb
ac
Bb
aa
zb
aE
aL
aV
zb
aa
aa
aa
aa
aa
"}
(17,1,1) = {"
aa
ac
aa
ac
aa
ac
aa
aa
zb
ag
ag
ag
zb
aa
aa
aa
aa
aa
"}
