//MAP CONVERTED BY dmm2tgm.py THIS HEADER COMMENT PREVENTS RECONVERSION, DO NOT REMOVE
"aa" = (
/turf/template_noop,
/area/template_noop)
"ab" = (
/obj/effect/decal/cleanable/dirt,
/obj/machinery/atmospherics/components/unary/vent_scrubber/on/layer2,
/turf/open/floor/iron/textured,
/area/ruin/space/djstation/solars)
"ac" = (
/obj/machinery/power/solar/fake,
/obj/structure/cable,
/turf/open/floor/iron/solarpanel/airless,
/area/ruin/space/djstation/solars)
"ad" = (
/obj/structure/cable,
/obj/structure/lattice/catwalk,
/obj/structure/lattice,
/turf/template_noop,
/area/space/nearstation)
"ae" = (
/obj/structure/lattice,
/turf/template_noop,
/area/space/nearstation)
"af" = (
/obj/structure/marker_beacon/white,
/obj/structure/lattice/catwalk,
/turf/template_noop,
/area/space/nearstation)
"ag" = (
/obj/structure/window/shuttle/survival_pod,
/obj/structure/grille,
/obj/structure/low_wall,
/obj/machinery/door/poddoor/shutters/preopen{
	id = "djstationkitchenette";
	dir = 4
	},
/turf/open/floor/plating,
/area/ruin/space/djstation/kitchenette)
"ah" = (
/obj/structure/cable,
/obj/effect/decal/cleanable/dirt/dust,
/obj/machinery/power/terminal{
	dir = 1
	},
/obj/structure/lattice/catwalk/plated/textured,
/obj/effect/decal/cleanable/dirt/dust,
/turf/open/floor/plating,
/area/ruin/space/djstation/solars)
"ai" = (
/obj/effect/mapping_helpers/smart_pipe/manifold4w/supply/hidden/layer4,
/obj/effect/mapping_helpers/smart_pipe/manifold4w/scrubbers/hidden/layer2,
/obj/structure/cable,
/turf/open/floor/iron/textured,
/area/ruin/space/djstation)
"aj" = (
/obj/effect/decal/cleanable/dirt,
/obj/machinery/atmospherics/components/unary/vent_pump/on/layer4{
	dir = 4
	},
/turf/open/floor/iron/textured,
/area/ruin/space/djstation/solars)
"ak" = (
/obj/effect/decal/cleanable/dirt,
/obj/effect/mapping_helpers/smart_pipe/manifold4w/supply/hidden/layer4,
/obj/machinery/atmospherics/components/unary/portables_connector/layer2,
/obj/machinery/portable_atmospherics/canister,
/obj/structure/cable,
/turf/open/floor/iron/textured,
/area/ruin/space/djstation/solars)
"al" = (
/obj/machinery/door/airlock/maintenance_hatch,
/obj/effect/mapping_helpers/smart_pipe/manifold4w/supply/hidden/layer4,
/obj/effect/mapping_helpers/smart_pipe/manifold4w/scrubbers/hidden/layer2,
/obj/structure/cable,
/obj/effect/decal/cleanable/dirt/dust,
/turf/open/floor/iron/textured,
/area/ruin/space/djstation/solars)
"am" = (
/obj/structure/cable,
/obj/machinery/door/airlock/external/glass{
	dir = 4
	},
/obj/effect/mapping_helpers/airlock/cyclelink_helper_multi,
/obj/structure/lattice/catwalk/plated/textured,
/obj/effect/decal/cleanable/dirt/dust,
/turf/open/floor/plating,
/area/ruin/space/djstation/solars)
"an" = (
/obj/structure/cable,
/obj/structure/lattice/catwalk,
/turf/template_noop,
/area/space/nearstation)
"ao" = (
/obj/effect/mapping_helpers/smart_pipe/manifold4w/supply/hidden/layer4,
/obj/effect/mapping_helpers/smart_pipe/manifold4w/scrubbers/hidden/layer2,
/obj/machinery/newscaster/directional/north,
/obj/structure/cable,
/obj/effect/spawner/lootdrop/crate_spawner,
/obj/effect/decal/cleanable/dirt/dust,
/turf/open/floor/iron/textured,
/area/ruin/space/djstation)
"ap" = (
/obj/structure/window/shuttle/survival_pod,
/obj/structure/grille,
/obj/structure/low_wall,
/obj/machinery/door/poddoor/shutters/preopen{
	id = "djstationengineering";
	dir = 4
	},
/turf/open/floor/plating,
/area/ruin/space/djstation/solars)
"aq" = (
/obj/effect/decal/cleanable/dirt,
/obj/machinery/button/door/directional/south{
	id = "djstationengineering"
	},
/obj/structure/rack,
/obj/item/multitool,
/obj/item/storage/toolbox/mechanical{
	pixel_x = -2;
	pixel_y = -1
	},
/obj/effect/decal/cleanable/dirt/dust,
/turf/open/floor/iron/textured,
/area/ruin/space/djstation/solars)
"ar" = (
/obj/effect/decal/cleanable/dirt,
/obj/effect/mapping_helpers/smart_pipe/manifold4w/supply/hidden/layer4,
/obj/effect/mapping_helpers/smart_pipe/manifold4w/scrubbers/hidden/layer2,
/obj/machinery/telecomms/relay/preset/djstation{
	layer = 3.01;
	pixel_y = 16
	},
/obj/structure/cable,
/obj/effect/decal/cleanable/dirt/dust,
/obj/effect/decal/cleanable/dirt/dust,
/turf/open/floor/iron/textured,
/area/ruin/space/djstation)
"as" = (
/obj/machinery/door/airlock/public/glass{
	name = "Rest Room";
	dir = 4
	},
/obj/effect/mapping_helpers/smart_pipe/manifold4w/supply/hidden/layer4,
/obj/effect/mapping_helpers/smart_pipe/manifold4w/scrubbers/hidden/layer2,
/obj/structure/cable,
/obj/effect/decal/cleanable/dirt/dust,
/turf/open/floor/iron/textured,
/area/ruin/space/djstation/bedroom)
"at" = (
/obj/structure/marker_beacon/olive,
/obj/structure/lattice/catwalk,
/turf/template_noop,
/area/space/nearstation)
"au" = (
/obj/effect/decal/cleanable/dirt,
/obj/effect/mapping_helpers/smart_pipe/manifold4w/supply/hidden/layer4,
/obj/effect/mapping_helpers/smart_pipe/manifold4w/scrubbers/hidden/layer2,
/obj/effect/spawner/lootdrop/space/syndiecosmetic,
/obj/machinery/power/apc/auto_name/north,
/obj/structure/cable,
/obj/effect/spawner/lootdrop/maintenance,
/obj/effect/spawner/lootdrop/maintenance,
/obj/structure/closet/crate/internals,
/obj/effect/decal/cleanable/dirt/dust,
/turf/open/floor/iron/textured,
/area/ruin/space/djstation)
"av" = (
/obj/machinery/light/small/directional/north,
/obj/effect/mapping_helpers/smart_pipe/manifold4w/supply/hidden/layer4,
/obj/effect/mapping_helpers/smart_pipe/manifold4w/scrubbers/hidden/layer2,
/obj/structure/cable,
/obj/machinery/jukebox{
	pixel_y = 16
	},
/turf/open/floor/iron/textured,
/area/ruin/space/djstation)
"aw" = (
/obj/effect/decal/cleanable/dirt,
/obj/effect/mapping_helpers/smart_pipe/manifold4w/supply/hidden/layer4,
/obj/machinery/atmospherics/components/unary/vent_scrubber/on/layer2{
	dir = 8
	},
/obj/structure/cable,
/turf/open/floor/iron/textured,
/area/ruin/space/djstation/bedroom)
"ax" = (
/obj/effect/decal/cleanable/dirt,
/obj/machinery/atmospherics/components/unary/vent_pump/on/layer4{
	dir = 8
	},
/obj/structure/chair/office/light{
	dir = 1
	},
/obj/effect/turf_decal/siding/thinplating{
	dir = 5
	},
/obj/effect/decal/cleanable/dirt/dust,
/turf/open/floor/carpet/executive,
/area/ruin/space/djstation/bedroom)
"ay" = (
/obj/structure/bed,
/obj/item/bedsheet/random,
/obj/effect/turf_decal/siding/thinplating{
	dir = 6
	},
/obj/effect/decal/cleanable/dirt/dust,
/obj/effect/decal/cleanable/dirt/dust,
/obj/effect/decal/cleanable/dirt/dust,
/turf/open/floor/carpet/executive,
/area/ruin/space/djstation/bedroom)
"az" = (
/obj/machinery/door/airlock/external{
	name = "Ruskie DJ Station"
	},
/obj/effect/decal/cleanable/dirt,
/obj/effect/mapping_helpers/airlock/cyclelink_helper_multi,
/obj/effect/decal/cleanable/dirt/dust,
/turf/open/floor/plating,
/area/ruin/space/djstation/solars)
"aB" = (
/obj/machinery/sleeper,
/obj/machinery/vending/wallmed/directional/north,
/obj/effect/decal/cleanable/dirt/dust,
/obj/effect/decal/cleanable/dirt/dust,
/turf/open/floor/iron/textured,
/area/ruin/space/djstation/bedroom)
"aC" = (
/obj/effect/decal/cleanable/dirt,
/obj/item/flashlight/lamp{
	pixel_y = 14
	},
/obj/structure/table,
/obj/item/paper_bin{
	pixel_x = 16;
	pixel_y = 9
	},
/obj/machinery/light_switch/directional/north,
/obj/effect/spawner/lootdrop/minor/pen,
/obj/machinery/power/apc/auto_name/north,
/obj/structure/cable,
/turf/open/floor/iron/textured,
/area/ruin/space/djstation/bedroom)
"aD" = (
/obj/structure/cable,
/obj/effect/decal/cleanable/dirt,
/obj/structure/lattice/catwalk,
/turf/template_noop,
/area/space/nearstation)
"aE" = (
/obj/structure/table,
/obj/structure/sign/poster/random{
	pixel_y = 32
	},
/obj/effect/decal/cleanable/dirt/dust,
/obj/effect/decal/cleanable/dirt/dust,
/turf/open/floor/iron/textured,
/area/ruin/space/djstation/bedroom)
"aG" = (
/obj/machinery/door/airlock/public/glass{
	name = "Kitchen";
	dir = 4
	},
/obj/effect/mapping_helpers/smart_pipe/manifold4w/supply/hidden/layer4,
/obj/effect/mapping_helpers/smart_pipe/manifold4w/scrubbers/hidden/layer2,
/obj/structure/cable,
/obj/effect/decal/cleanable/dirt/dust,
/turf/open/floor/iron/textured,
/area/ruin/space/djstation/kitchenette)
"aH" = (
/obj/item/radio/intercom{
	dir = 8;
	freerange = 1;
	name = "Pirate Radio Listening Channel"
	},
/obj/effect/decal/cleanable/dirt/dust,
/obj/structure/table/reinforced/plastitaniumglass,
/obj/machinery/atmospherics/components/unary/vent_scrubber/on/layer2{
	dir = 8
	},
/obj/effect/turf_decal/siding/thinplating{
	dir = 8
	},
/turf/open/floor/carpet/neon,
/area/ruin/space/djstation)
"aI" = (
/obj/structure/chair/office/light,
/obj/effect/decal/cleanable/dirt/dust,
/turf/open/floor/carpet/neon,
/area/ruin/space/djstation)
"aJ" = (
/obj/item/radio/intercom{
	dir = 8;
	freerange = 1;
	name = "Pirate Radio Listening Channel"
	},
/obj/effect/decal/cleanable/dirt/dust,
/obj/structure/table/reinforced/plastitaniumglass,
/obj/machinery/atmospherics/components/unary/vent_pump/on/layer4{
	dir = 4
	},
/obj/effect/turf_decal/siding/thinplating{
	dir = 4
	},
/turf/open/floor/carpet/neon,
/area/ruin/space/djstation)
"aK" = (
/obj/structure/marker_beacon/burgundy,
/obj/structure/lattice/catwalk,
/turf/template_noop,
/area/space/nearstation)
"aN" = (
/obj/machinery/disposal/bin,
/obj/structure/disposalpipe/trunk,
/obj/effect/decal/cleanable/dirt/dust,
/obj/effect/decal/cleanable/dirt/dust,
/turf/open/floor/iron/cafeteria,
/area/ruin/space/djstation/kitchenette)
"aO" = (
/obj/effect/decal/cleanable/dirt/dust,
/obj/structure/table,
/obj/item/thermometer/pen,
/obj/machinery/light/directional/south,
/obj/effect/decal/cleanable/dirt/dust,
/turf/open/floor/iron/cafeteria,
/area/ruin/space/djstation/kitchenette)
"aP" = (
/obj/effect/spawner/lootdrop/maintenance,
/obj/effect/decal/cleanable/dirt/dust,
/obj/structure/table/reinforced/plastitaniumglass,
/obj/effect/turf_decal/siding/thinplating{
	dir = 10
	},
/turf/open/floor/carpet/neon,
/area/ruin/space/djstation)
"aQ" = (
/obj/item/radio/intercom{
	broadcasting = 1;
	dir = 8;
	freerange = 1;
	listening = 0;
	name = "Pirate Radio Broadcast Channel"
	},
/obj/structure/table/reinforced/plastitaniumglass,
/obj/effect/turf_decal/siding/thinplating,
/turf/open/floor/carpet/neon,
/area/ruin/space/djstation)
"aR" = (
/obj/item/paper/fluff/ruins/djstation,
/obj/effect/decal/cleanable/dirt/dust,
/obj/structure/table/reinforced/plastitaniumglass,
/obj/effect/turf_decal/siding/thinplating{
	dir = 6
	},
/turf/open/floor/carpet/neon,
/area/ruin/space/djstation)
"aS" = (
/obj/effect/decal/cleanable/dirt,
/obj/machinery/button/door/directional/south{
	id = "djstationbedroom"
	},
/obj/structure/closet/crate/trashcart/laundry,
/obj/item/clothing/under/pants/cargoshorts,
/obj/effect/spawner/lootdrop/clothes,
/obj/item/clothing/under/sweater,
/obj/effect/decal/cleanable/dirt/dust,
/turf/open/floor/iron/textured,
/area/ruin/space/djstation/bedroom)
"aT" = (
/obj/effect/decal/cleanable/dirt,
/obj/machinery/light/directional/south,
/obj/effect/spawner/lootdrop/medkit,
/obj/effect/spawner/lootdrop/maintenance,
/obj/effect/spawner/lootdrop/clothes,
/obj/structure/closet,
/obj/effect/turf_decal/siding/thinplating{
	dir = 10
	},
/obj/effect/decal/cleanable/dirt/dust,
/turf/open/floor/carpet/executive,
/area/ruin/space/djstation/bedroom)
"aV" = (
/obj/structure/window/shuttle/survival_pod,
/obj/structure/grille,
/obj/structure/low_wall,
/obj/machinery/door/poddoor/shutters/preopen{
	id = "djstationbedroom";
	dir = 4
	},
/turf/open/floor/plating,
/area/ruin/space/djstation/bedroom)
"aW" = (
/obj/structure/disposalpipe/segment,
/obj/effect/mapping_helpers/paint_wall/skyline/inner_hull/cook,
/turf/closed/wall,
/area/ruin/space/djstation/kitchenette)
"aX" = (
/obj/machinery/door/airlock/hatch{
	name = "Washroom"
	},
/obj/effect/decal/cleanable/dirt/dust,
/turf/open/floor/iron/freezer,
/area/ruin/space/djstation)
"bb" = (
/obj/item/clothing/suit/space/orange,
/obj/item/clothing/mask/breath,
/obj/structure/rack,
/obj/item/clothing/head/helmet/space/orange,
/obj/structure/window/reinforced{
	dir = 1
	},
/obj/effect/decal/cleanable/dirt/dust,
/turf/open/floor/iron/textured,
/area/ruin/space/djstation)
"be" = (
/obj/structure/sink{
	dir = 4;
	pixel_x = -12;
	pixel_y = 2
	},
/obj/effect/decal/cleanable/dirt/dust,
/turf/open/floor/iron/freezer,
/area/ruin/space/djstation)
"bf" = (
/obj/structure/toilet{
	pixel_y = 8
	},
/obj/machinery/light/small/directional/south,
/obj/effect/decal/cleanable/dirt/dust,
/turf/open/floor/iron/freezer,
/area/ruin/space/djstation)
"bg" = (
/obj/structure/sign/warning/vacuum/external{
	pixel_y = -32
	},
/obj/effect/decal/cleanable/dirt,
/obj/effect/turf_decal/stripes/asteroid/line,
/obj/structure/closet/emcloset,
/obj/effect/turf_decal/box/red,
/turf/open/floor/iron/textured,
/area/ruin/space/djstation)
"bi" = (
/obj/machinery/door/airlock/external{
	name = "Ruskie DJ Station"
	},
/obj/effect/mapping_helpers/airlock/cyclelink_helper,
/obj/effect/decal/cleanable/dirt,
/turf/open/floor/plating,
/area/ruin/space/djstation)
"cp" = (
/obj/machinery/power/smes/magical{
	desc = "A high-capacity superconducting magnetic energy storage (SMES) unit.";
	name = "power storage unit"
	},
/obj/structure/cable,
/obj/structure/lattice/catwalk/plated/textured,
/obj/effect/decal/cleanable/dirt/dust,
/turf/open/floor/plating,
/area/ruin/space/djstation/solars)
"ct" = (
/obj/effect/decal/cleanable/dirt/dust,
/obj/effect/mapping_helpers/smart_pipe/manifold4w/supply/hidden/layer4,
/obj/structure/cable,
/turf/open/floor/iron/cafeteria,
/area/ruin/space/djstation/kitchenette)
"cN" = (
/obj/effect/decal/cleanable/dirt,
/obj/effect/mapping_helpers/smart_pipe/manifold4w/supply/hidden/layer4,
/obj/effect/mapping_helpers/smart_pipe/manifold4w/scrubbers/hidden/layer2,
/obj/structure/cable,
/turf/open/floor/iron/textured,
/area/ruin/space/djstation)
"fj" = (
/obj/effect/mapping_helpers/smart_pipe/manifold4w/supply/hidden/layer4,
/obj/machinery/atmospherics/components/binary/pump/layer2{
	dir = 1
	},
/obj/structure/lattice/catwalk/plated/textured,
/obj/structure/cable,
/obj/effect/decal/cleanable/dirt/dust,
/turf/open/floor/plating,
/area/ruin/space/djstation/solars)
"gd" = (
/obj/effect/mapping_helpers/paint_wall/skyline/inner_hull/cook,
/turf/closed/wall,
/area/ruin/space/djstation/solars)
"hk" = (
/obj/machinery/light/directional/south,
/obj/effect/decal/cleanable/dirt/dust,
/turf/open/floor/iron/textured,
/area/ruin/space/djstation)
"jz" = (
/obj/effect/decal/cleanable/dirt/dust,
/obj/effect/mapping_helpers/smart_pipe/manifold4w/supply/hidden/layer4,
/obj/machinery/atmospherics/components/unary/vent_scrubber/on/layer2{
	dir = 4
	},
/obj/structure/cable,
/turf/open/floor/iron/cafeteria,
/area/ruin/space/djstation/kitchenette)
"kv" = (
/obj/effect/mapping_helpers/smart_pipe/manifold4w/supply/hidden/layer4,
/obj/effect/mapping_helpers/smart_pipe/manifold4w/scrubbers/hidden/layer2,
/obj/structure/cable,
/turf/open/floor/iron/textured,
/area/ruin/space/djstation/solars)
"lq" = (
/obj/effect/decal/cleanable/dirt,
/obj/machinery/light/small/directional/east,
/turf/open/floor/plating,
/area/ruin/space/djstation)
"nx" = (
/obj/effect/mapping_helpers/paint_wall/skyline/inner_hull/cook,
/obj/effect/mapping_helpers/paint_wall/skyline/inner_hull/cook,
/turf/closed/wall,
/area/ruin/space/djstation/solars)
"rh" = (
/obj/structure/cable,
/obj/machinery/power/tracker,
/turf/open/floor/iron/solarpanel/airless,
/area/ruin/space/djstation/solars)
"ru" = (
/obj/effect/turf_decal/stripes/asteroid/line,
/obj/effect/decal/cleanable/dirt/dust,
/obj/effect/decal/cleanable/dirt/dust,
/turf/open/floor/iron/textured,
/area/ruin/space/djstation)
"rS" = (
/obj/effect/mapping_helpers/smart_pipe/manifold4w/supply/hidden/layer4,
/obj/effect/mapping_helpers/smart_pipe/manifold4w/scrubbers/hidden/layer2,
/obj/structure/cable,
/obj/effect/decal/cleanable/dirt/dust,
/turf/open/floor/iron/textured,
/area/ruin/space/djstation)
"su" = (
/obj/effect/decal/cleanable/dirt,
/obj/effect/mapping_helpers/smart_pipe/manifold4w/supply/hidden/layer4,
/obj/effect/mapping_helpers/smart_pipe/manifold4w/scrubbers/hidden/layer2,
/obj/structure/cable,
/obj/effect/decal/cleanable/dirt/dust,
/turf/open/floor/iron/textured,
/area/ruin/space/djstation)
"td" = (
/obj/effect/decal/cleanable/dirt/dust,
/obj/effect/mapping_helpers/smart_pipe/manifold4w/supply/hidden/layer4,
/obj/effect/mapping_helpers/smart_pipe/manifold4w/scrubbers/hidden/layer2,
/obj/machinery/cell_charger{
	layer = 3.01
	},
/obj/structure/table,
/obj/structure/lattice/catwalk/plated/textured,
/obj/structure/cable,
/turf/open/floor/plating,
/area/ruin/space/djstation/solars)
"ts" = (
/obj/structure/cable,
/obj/machinery/power/solar_control{
	dir = 4
	},
/obj/structure/lattice/catwalk/plated/textured,
/obj/effect/decal/cleanable/dirt/dust,
/turf/open/floor/plating,
/area/ruin/space/djstation/solars)
"uk" = (
/obj/machinery/atmospherics/components/unary/vent_pump/on/layer4{
	dir = 4
	},
/obj/effect/decal/cleanable/dirt/dust,
/obj/effect/decal/cleanable/dirt/dust,
/turf/open/floor/iron/cafeteria,
/area/ruin/space/djstation/kitchenette)
"uu" = (
/obj/effect/mapping_helpers/paint_wall/skyline/inner_hull/cook,
/turf/closed/wall,
/area/ruin/space/djstation/kitchenette)
"uK" = (
/obj/effect/decal/cleanable/dirt/dust,
/obj/effect/turf_decal/siding/thinplating{
	dir = 5
	},
/turf/open/floor/carpet/neon,
/area/ruin/space/djstation)
"xX" = (
/obj/effect/decal/cleanable/dirt/dust,
/obj/effect/turf_decal/siding/thinplating{
	dir = 1
	},
/turf/open/floor/carpet/neon,
/area/ruin/space/djstation)
"yY" = (
/obj/machinery/light/directional/north,
/obj/structure/cable,
/obj/machinery/power/apc/auto_name/north,
/obj/structure/lattice/catwalk/plated/textured,
/obj/effect/decal/cleanable/dirt/dust,
/turf/open/floor/plating,
/area/ruin/space/djstation/solars)
"zb" = (
/obj/effect/mapping_helpers/paint_wall/skyline/inner_hull/cook,
/turf/closed/wall,
/area/ruin/space/djstation)
"Au" = (
/obj/machinery/space_heater{
	pixel_y = 16;
	layer = 3.1;
	pixel_x = 9
	},
/obj/structure/tank_holder/extinguisher/advanced{
	layer = 3.11;
	pixel_x = 8
	},
/obj/effect/mapping_helpers/smart_pipe/manifold4w/supply/hidden/layer4,
/obj/effect/mapping_helpers/smart_pipe/manifold4w/scrubbers/hidden/layer2,
/obj/structure/lattice/catwalk/plated/textured,
/obj/structure/cable,
/turf/open/floor/plating,
/area/ruin/space/djstation/solars)
"Bb" = (
/obj/machinery/power/solar/fake,
/obj/structure/cable,
/obj/effect/decal/cleanable/dirt,
/turf/open/floor/iron/solarpanel/airless,
/area/ruin/space/djstation/solars)
"BY" = (
/obj/effect/decal/cleanable/dirt,
/obj/structure/rack,
/obj/item/storage/box/lights/mixed,
/obj/effect/decal/cleanable/dirt/dust,
/turf/open/floor/iron/textured,
/area/ruin/space/djstation/solars)
"Co" = (
/obj/machinery/door/airlock/external{
	name = "Ruskie DJ Station"
	},
/obj/effect/mapping_helpers/airlock/cyclelink_helper{
	dir = 1
	},
/turf/open/floor/plating,
/area/ruin/space/djstation)
"CU" = (
/obj/structure/cable,
/obj/effect/decal/cleanable/dirt,
/obj/structure/lattice/catwalk/plated/dark,
/turf/open/floor/plating/airless,
/area/ruin/space/djstation/solars)
"Ju" = (
/obj/effect/decal/cleanable/dirt/dust,
/turf/open/floor/iron/textured,
/area/ruin/space/djstation/solars)
"KA" = (
/obj/effect/decal/cleanable/dirt/dust,
/obj/item/mop,
/obj/item/reagent_containers/glass/bucket,
/obj/structure/reagent_dispensers/watertank,
/obj/machinery/door/window/survival_pod{
	dir = 8
	},
/obj/effect/decal/cleanable/dirt/dust,
/turf/open/floor/iron/freezer,
/area/ruin/space/djstation)
"Lm" = (
/obj/effect/decal/cleanable/dirt/dust,
/obj/machinery/vending/snack,
/obj/machinery/computer/security/telescreen/entertainment/directional/north,
/turf/open/floor/iron/cafeteria,
/area/ruin/space/djstation/kitchenette)
"LC" = (
/obj/effect/decal/cleanable/dirt/dust,
/obj/machinery/light_switch/directional/west,
/turf/open/floor/iron/textured,
/area/ruin/space/djstation)
"ME" = (
/obj/structure/table,
/obj/machinery/microwave{
	pixel_y = 8;
	dir = 1
	},
/obj/effect/decal/cleanable/dirt/dust,
/obj/effect/decal/cleanable/dirt/dust,
/turf/open/floor/iron/cafeteria,
/area/ruin/space/djstation/kitchenette)
"NH" = (
/obj/effect/mapping_helpers/smart_pipe/manifold4w/supply/hidden/layer4,
/obj/structure/cable,
/obj/effect/turf_decal/siding/thinplating{
	dir = 9
	},
/obj/effect/decal/cleanable/dirt/dust,
/obj/effect/decal/cleanable/dirt/dust,
/turf/open/floor/carpet/executive,
/area/ruin/space/djstation/bedroom)
"OW" = (
/obj/effect/decal/cleanable/dirt/dust,
/obj/structure/table,
/obj/effect/spawner/lootdrop/donkpockets,
/obj/machinery/power/apc/auto_name/north,
/obj/structure/cable,
/obj/effect/decal/cleanable/dirt/dust,
/turf/open/floor/iron/cafeteria,
/area/ruin/space/djstation/kitchenette)
"Pq" = (
/obj/structure/disposaloutlet{
	dir = 8
	},
/obj/structure/disposalpipe/trunk{
	dir = 1
	},
/obj/structure/lattice,
/turf/template_noop,
/area/ruin/space/djstation/kitchenette)
"Ry" = (
/obj/effect/decal/cleanable/dirt/dust,
/obj/effect/turf_decal/siding/thinplating{
	dir = 9
	},
/turf/open/floor/carpet/neon,
/area/ruin/space/djstation)
"Vk" = (
/obj/structure/window/shuttle/survival_pod,
/obj/structure/grille,
/obj/structure/low_wall,
/obj/machinery/door/poddoor/shutters/preopen{
	id = "djstationengineering"
	},
/turf/open/floor/plating,
/area/ruin/space/djstation/solars)
"Vq" = (
/obj/effect/decal/cleanable/dirt/dust,
/obj/structure/table/rolling,
/obj/item/storage/bag/tray/cafeteria{
	pixel_y = 7;
	pixel_x = -1
	},
/obj/effect/decal/cleanable/dirt/dust,
/obj/effect/decal/cleanable/dirt/dust,
/turf/open/floor/iron/cafeteria,
/area/ruin/space/djstation/kitchenette)
"WZ" = (
/obj/effect/mapping_helpers/paint_wall/skyline/inner_hull/cook,
/turf/closed/wall,
/area/ruin/space/djstation/bedroom)
"Yn" = (
/obj/effect/decal/cleanable/dirt/dust,
/turf/open/floor/iron/textured,
/area/ruin/space/djstation)
"Zh" = (
/obj/structure/cable,
/obj/effect/decal/cleanable/dirt/dust,
/obj/structure/lattice/catwalk/plated/textured,
/obj/effect/decal/cleanable/dirt/dust,
/turf/open/floor/plating,
/area/ruin/space/djstation/solars)
"ZF" = (
/obj/effect/decal/cleanable/dirt,
/obj/machinery/portable_atmospherics/canister/air,
/obj/machinery/atmospherics/components/unary/portables_connector/layer4,
/obj/structure/cable,
/turf/open/floor/iron/textured,
/area/ruin/space/djstation/solars)

(1,1,1) = {"
Bb
ac
ac
Bb
Bb
Bb
CU
Bb
Bb
Bb
Bb
Bb
Bb
aa
aa
aa
aa
aa
aa
aa
aa
aa
aa
aa
aa
aa
aa
aa
aa
aa
aa
aa
"}
(2,1,1) = {"
Bb
ac
ac
Bb
Bb
Bb
CU
Bb
Bb
Bb
Bb
Bb
Bb
aa
aa
aa
aa
aa
aa
aa
aa
aa
aa
aa
aa
aa
aa
aa
aa
aa
aa
aa
"}
(3,1,1) = {"
aa
ae
aa
aa
aa
aa
CU
aa
aa
aa
aa
ae
aa
aa
aa
aa
aa
aa
aa
aa
aa
aa
aa
aa
aa
aa
aa
aa
aa
aa
aa
aa
"}
(4,1,1) = {"
Bb
Bb
Bb
Bb
Bb
Bb
CU
Bb
Bb
Bb
ac
Bb
ac
aa
aa
aa
aa
aa
aa
aa
aa
aa
aa
aa
aa
aa
aa
aa
aa
aa
aa
aa
"}
(5,1,1) = {"
Bb
Bb
Bb
Bb
Bb
Bb
CU
ac
Bb
Bb
ac
Bb
ac
aa
aa
aa
aa
aa
aa
aa
aa
aa
aa
aa
aa
aa
aa
aa
aa
aa
aa
aa
"}
(6,1,1) = {"
aa
ae
aa
aa
aa
aa
CU
aa
aa
aa
aa
ae
ae
ae
ae
ae
ae
at
ae
ae
ae
ae
uu
ag
ag
ag
uu
aa
aa
aa
aa
aa
"}
(7,1,1) = {"
Bb
Bb
Bb
ac
Bb
ac
CU
Bb
Bb
Bb
Bb
Bb
Bb
aa
aa
aa
aa
ae
aa
aa
aa
aa
uu
ME
uk
aN
aW
Pq
aa
aa
aa
aa
"}
(8,1,1) = {"
ac
Bb
Bb
ac
Bb
ac
CU
Bb
Bb
Bb
Bb
Bb
Bb
aa
aa
aa
aa
ae
aa
aa
aa
aa
uu
OW
ct
aO
uu
ae
aa
aa
aa
aa
"}
(9,1,1) = {"
aa
ae
aa
aa
aa
aa
CU
aa
aa
aa
aa
ae
aa
aa
aa
aa
aa
gd
ap
gd
aa
aa
uu
Lm
jz
Vq
uu
ae
aa
aa
aa
aa
"}
(10,1,1) = {"
Bb
Bb
Bb
Bb
Bb
Bb
CU
Bb
Bb
Bb
Bb
Bb
Bb
aa
an
an
an
az
Zh
gd
aa
gd
uu
ag
aG
ag
uu
zb
zb
zb
zb
zb
"}
(11,1,1) = {"
Bb
Bb
Bb
Bb
Bb
Bb
CU
Bb
Bb
Bb
Bb
Bb
Bb
aa
an
gd
ap
gd
am
gd
ap
nx
au
su
cN
Yn
LC
Yn
ru
bi
lq
Co
"}
(12,1,1) = {"
aa
ae
aa
aa
aa
aa
CU
aa
aa
aa
aa
ae
aa
aa
an
Vk
ts
cp
ah
BY
aq
gd
av
Ry
aH
aP
Yn
bb
bg
zb
zb
zb
"}
(13,1,1) = {"
af
rh
ad
ad
ad
ad
CU
an
an
an
an
an
an
aD
an
gd
yY
aj
Ju
ab
kv
al
ai
xX
aI
aQ
hk
zb
zb
zb
ae
af
"}
(14,1,1) = {"
aa
ae
aa
aa
aa
aa
CU
aa
aa
aa
aa
ae
aa
aa
aa
Vk
ZF
ak
fj
td
Au
gd
ao
uK
aJ
aR
Yn
aX
be
zb
aa
aa
"}
(15,1,1) = {"
Bb
ac
ac
Bb
Bb
Bb
CU
Bb
ac
ac
Bb
Bb
Bb
aa
aa
gd
ap
ap
ap
ap
ap
gd
ar
rS
rS
Yn
Yn
zb
bf
zb
aa
aa
"}
(16,1,1) = {"
Bb
ac
ac
Bb
Bb
Bb
CU
Bb
ac
ac
Bb
Bb
Bb
aa
aa
aa
aa
ae
aa
aa
aa
gd
WZ
aV
as
aV
WZ
zb
KA
zb
aa
aa
"}
(17,1,1) = {"
aa
ae
aa
aa
aa
aa
CU
aa
aa
aa
aa
ae
aa
aa
aa
aa
aa
ae
aa
aa
aa
aa
WZ
aB
aw
aS
WZ
zb
zb
zb
aa
aa
"}
(18,1,1) = {"
Bb
Bb
Bb
Bb
Bb
Bb
CU
Bb
Bb
Bb
Bb
Bb
Bb
aa
aa
aa
aa
ae
aa
aa
aa
aa
WZ
aC
NH
aT
WZ
aa
aa
aa
aa
aa
"}
(19,1,1) = {"
Bb
Bb
Bb
Bb
Bb
Bb
CU
Bb
Bb
Bb
Bb
Bb
Bb
aa
aa
aa
aa
ae
aa
aa
aa
aa
WZ
aE
ax
ay
WZ
aa
aa
aa
aa
aa
"}
(20,1,1) = {"
aa
ae
aa
aa
aa
aa
CU
aa
aa
aa
aa
ae
ae
ae
ae
ae
ae
aK
ae
ae
ae
ae
WZ
aV
aV
aV
WZ
aa
aa
aa
aa
aa
"}
(21,1,1) = {"
Bb
Bb
Bb
ac
Bb
ac
CU
Bb
Bb
Bb
ac
Bb
ac
aa
aa
aa
aa
aa
aa
aa
aa
aa
aa
aa
aa
aa
aa
aa
aa
aa
aa
aa
"}
(22,1,1) = {"
ac
Bb
Bb
ac
Bb
ac
CU
ac
Bb
Bb
ac
Bb
ac
aa
aa
aa
aa
aa
aa
aa
aa
aa
aa
aa
aa
aa
aa
aa
aa
aa
aa
aa
"}
(23,1,1) = {"
aa
ae
aa
aa
aa
aa
CU
aa
aa
aa
aa
ae
aa
aa
aa
aa
aa
aa
aa
aa
aa
aa
aa
aa
aa
aa
aa
aa
aa
aa
aa
aa
"}
(24,1,1) = {"
Bb
Bb
Bb
Bb
Bb
Bb
CU
Bb
Bb
Bb
Bb
Bb
Bb
aa
aa
aa
aa
aa
aa
aa
aa
aa
aa
aa
aa
aa
aa
aa
aa
aa
aa
aa
"}
(25,1,1) = {"
Bb
Bb
Bb
Bb
Bb
Bb
CU
Bb
Bb
Bb
Bb
Bb
Bb
aa
aa
aa
aa
aa
aa
aa
aa
aa
aa
aa
aa
aa
aa
aa
aa
aa
aa
aa
"}
