//MAP CONVERTED BY dmm2tgm.py THIS HEADER COMMENT PREVENTS RECONVERSION, DO NOT REMOVE
"bd" = (
/obj/machinery/atmospherics/pipe/heat_exchanging/simple{
	dir = 6
	},
/turf/open/space/basic,
/area/template_noop)
"cc" = (
/obj/effect/spawner/lootdrop/toolbox,
/turf/open/space/basic,
/area/template_noop)
"ci" = (
/turf/open/floor/mineral/titanium/airless,
/area/ruin/unpowered)
"cI" = (
/obj/item/rack_parts/shelf,
/turf/open/floor/engine/airless,
/area/ruin/unpowered)
"dk" = (
/obj/structure/closet/crate/engineering,
/obj/effect/spawner/lootdrop/space/fancytool/engineonly,
/obj/effect/spawner/lootdrop/space/fancytool/engineonly,
/obj/effect/spawner/lootdrop/space/fancytool/engineonly,
/obj/effect/spawner/lootdrop/space/fancytool/engineonly,
/turf/open/space/basic,
/area/template_noop)
"dx" = (
/obj/structure/window/plasma/reinforced{
	dir = 4
	},
/obj/machinery/power/rad_collector/anchored,
/obj/structure/cable,
/turf/open/floor/engine/airless,
/area/ruin/unpowered)
"fB" = (
/obj/structure/frame/machine,
/turf/open/floor/mineral/titanium,
/area/ruin/unpowered)
"iq" = (
/obj/machinery/door/poddoor/shutters/radiation,
/turf/open/floor/mineral/titanium/airless,
/area/ruin/unpowered)
"iw" = (
/obj/machinery/light/small/broken/directional/east,
/turf/open/floor/mineral/titanium/airless,
/area/ruin/unpowered)
"km" = (
/obj/machinery/light/small/broken/directional/west,
/turf/open/floor/mineral/titanium/airless,
/area/ruin/unpowered)
"ks" = (
/obj/item/stack/sheet/mineral/titanium,
/turf/open/space/basic,
/area/template_noop)
"kX" = (
/obj/machinery/computer/shuttle{
	dir = 1
	},
/turf/open/floor/mineral/titanium/airless,
/area/ruin/unpowered)
"lp" = (
/obj/effect/spawner/lootdrop/powercell,
/turf/open/space/basic,
/area/template_noop)
"nf" = (
/obj/machinery/atmospherics/pipe/heat_exchanging/simple{
	dir = 5
	},
/turf/open/space/basic,
/area/template_noop)
"nz" = (
/obj/structure/cable,
/turf/open/floor/mineral/titanium/airless,
/area/ruin/unpowered)
"pC" = (
/obj/structure/rack/shelf,
/turf/open/space/basic,
/area/template_noop)
"pO" = (
/obj/structure/rack/shelf,
/obj/machinery/light/small/broken/directional/east,
/turf/open/floor/mineral/titanium/airless,
/area/ruin/unpowered)
"qO" = (
/obj/machinery/atmospherics/pipe/heat_exchanging/manifold{
	dir = 4
	},
/turf/open/space/basic,
/area/template_noop)
"sg" = (
/obj/structure/closet/crate/engineering,
/obj/item/fireaxe/metal_h2_axe,
/obj/effect/spawner/lootdrop/space/fancytool/engineonly,
/obj/effect/spawner/lootdrop/space/fancytool/engineonly,
/obj/effect/spawner/lootdrop/space/fancytool/engineonly,
/turf/open/space/basic,
/area/template_noop)
"tp" = (
/obj/structure/lattice,
/turf/open/space/basic,
/area/ruin/unpowered)
"vp" = (
/obj/effect/mapping_helpers/paint_wall/skyline/inner_hull/engineering,
/turf/closed/wall/mineral/titanium,
/area/ruin/unpowered)
"vv" = (
/obj/effect/mob_spawn/human/engineer,
/turf/open/space/basic,
/area/template_noop)
"wL" = (
/obj/item/crowbar/power,
/turf/open/space/basic,
/area/template_noop)
"wS" = (
/obj/machinery/atmospherics/pipe/heat_exchanging/simple{
	dir = 9
	},
/turf/open/space/basic,
/area/template_noop)
"wX" = (
/obj/machinery/atmospherics/pipe/heat_exchanging/simple{
	dir = 10
	},
/turf/open/space/basic,
/area/template_noop)
"xH" = (
/obj/item/organ/cyberimp/arm/toolset,
/turf/open/space/basic,
/area/template_noop)
"yD" = (
/obj/item/rack_parts/shelf,
/turf/open/space/basic,
/area/template_noop)
"Ap" = (
/turf/open/space/basic,
/area/template_noop)
"AL" = (
/obj/item/screwdriver/power,
/turf/open/space/basic,
/area/template_noop)
"BW" = (
/obj/item/stack/cable_coil/five,
/turf/open/space/basic,
/area/template_noop)
"CJ" = (
/obj/effect/spawner/lootdrop/tool,
/turf/open/space/basic,
/area/template_noop)
"DX" = (
/obj/structure/rack/shelf,
/turf/open/floor/mineral/titanium/airless,
/area/ruin/unpowered)
"Gi" = (
/obj/machinery/atmospherics/pipe/heat_exchanging/manifold{
	dir = 8
	},
/turf/open/space/basic,
/area/template_noop)
"GC" = (
/obj/structure/lattice,
/obj/structure/frame/machine,
/turf/open/space/basic,
/area/ruin/unpowered)
"GZ" = (
/obj/machinery/light/broken/directional/west,
/turf/open/floor/engine/airless,
/area/ruin/unpowered)
"Hc" = (
/obj/machinery/atmospherics/pipe/heat_exchanging/manifold4w,
/turf/open/space/basic,
/area/template_noop)
"HA" = (
/turf/open/floor/engine/airless,
/area/ruin/unpowered)
"Ig" = (
/obj/structure/frame/machine,
/turf/open/floor/engine/airless,
/area/ruin/unpowered)
"IB" = (
/obj/machinery/power/apc/auto_name/east,
/obj/structure/cable,
/turf/open/floor/mineral/titanium/airless,
/area/ruin/unpowered)
"IJ" = (
/obj/structure/closet/crate/engineering,
/obj/effect/spawner/lootdrop/material,
/obj/effect/spawner/lootdrop/material,
/obj/effect/spawner/lootdrop/material,
/turf/open/space/basic,
/area/template_noop)
"Kg" = (
/obj/machinery/door/airlock/maintenance/external{
	dir = 4
	},
/turf/open/floor/mineral/titanium/airless,
/area/ruin/unpowered)
"Mt" = (
/obj/machinery/power/apc/auto_name/west,
/obj/structure/cable,
/turf/open/floor/engine/airless,
/area/ruin/unpowered)
"PP" = (
/obj/structure/table/reinforced,
/obj/machinery/shuttle_comms/active{
	pixel_y = 5
	},
/turf/open/floor/mineral/titanium/airless,
/area/ruin/unpowered)
"Rv" = (
/obj/structure/chair/comfy/shuttle,
/turf/open/floor/mineral/titanium/airless,
/area/ruin/unpowered)
"RJ" = (
/obj/structure/window/reinforced/fulltile,
/obj/structure/grille,
/obj/structure/low_wall/titanium,
/turf/open/floor/mineral/titanium/airless,
/area/ruin/unpowered)
"Sp" = (
/obj/machinery/light/broken/directional/west,
/turf/open/floor/mineral/titanium/airless,
/area/ruin/unpowered)
"St" = (
/obj/machinery/light/broken/directional/east,
/turf/open/floor/mineral/titanium/airless,
/area/ruin/unpowered)
"Tn" = (
/obj/machinery/atmospherics/pipe/heat_exchanging/junction{
	dir = 4
	},
/obj/effect/mapping_helpers/paint_wall/skyline/inner_hull/engineering,
/turf/closed/wall/mineral/titanium,
/area/ruin/unpowered)
"TU" = (
/obj/effect/mapping_helpers/paint_wall/skyline/inner_hull/engineering,
/obj/machinery/atmospherics/components/unary/engine{
	dir = 1
	},
/turf/closed/wall/mineral/titanium,
/area/ruin/unpowered)
"Uq" = (
/obj/machinery/light/broken/directional/east,
/turf/open/floor/engine/airless,
/area/ruin/unpowered)
"Uz" = (
/obj/structure/window/plasma/reinforced{
	dir = 8
	},
/turf/open/floor/engine/airless,
/area/ruin/unpowered)
"UQ" = (
/obj/structure/cable,
/turf/open/floor/engine/airless,
/area/ruin/unpowered)
"Ve" = (
/obj/effect/spawner/lootdrop/material_scarce,
/turf/open/space/basic,
/area/template_noop)
"Ws" = (
/obj/structure/closet/crate/engineering,
/obj/effect/spawner/lootdrop/space/fancytool/engineonly,
/obj/effect/spawner/lootdrop/space/fancytool/engineonly,
/obj/effect/spawner/lootdrop/space/fancytool/engineonly,
/turf/open/space/basic,
/area/template_noop)

(1,1,1) = {"
Ap
Ap
Ap
Ap
Ap
Ap
BW
Ap
Ap
CJ
Ap
Ap
ks
Ap
Ap
Ap
Ap
Ap
Ap
Ap
Ap
Ap
Ap
Ap
Ap
Ap
Ap
Ap
Ap
Ap
Ap
Ap
Ap
Ap
Ap
Ap
Ap
Ap
Ap
Ap
Ap
Ap
Ap
Ap
Ap
Ap
"}
(2,1,1) = {"
Ap
Ap
Ap
Ap
lp
Ap
Ap
Ap
Ap
Ap
Ap
Ap
Ap
Ap
Ap
yD
Ap
Ap
Ap
Ap
Ap
Ap
Ap
Ve
vp
vp
vp
vp
vp
vp
vp
vp
vp
vp
vp
Ap
Ap
Ap
Ap
Ap
Ap
Ap
Ap
Ap
Ap
Ap
"}
(3,1,1) = {"
Ap
Ap
Ap
Ap
Ap
wL
Ap
Ap
Ap
Ap
Ap
ks
vv
Ap
BW
Ap
Ap
ks
dk
Ap
Ap
Ap
Ap
Ap
vp
HA
HA
Mt
GZ
HA
HA
iq
Sp
ci
vp
vp
Ap
Ap
Ap
Ap
Ap
Ap
Ap
Ap
Ap
Ap
"}
(4,1,1) = {"
Ap
Ap
lp
Ap
cc
Ap
vv
IJ
ks
Ap
Ap
Ap
Ap
cc
Ap
Ap
Ap
Ap
Ap
Ap
cc
Ap
Ap
Ap
TU
cI
HA
UQ
HA
HA
HA
iq
ci
ci
ci
vp
vp
Kg
Kg
vp
vp
vp
Ap
Ap
Ap
Ap
"}
(5,1,1) = {"
Ap
Ap
Ap
ks
Ap
xH
Ap
Ap
Ap
CJ
lp
Ap
ks
Ap
CJ
Ap
pC
wL
Ap
Ap
Ap
ks
Ap
Ap
tp
HA
HA
dx
dx
UQ
UQ
iq
ci
ci
ci
ci
km
ci
ci
km
DX
vp
RJ
RJ
RJ
RJ
"}
(6,1,1) = {"
Ap
lp
Ap
Ap
lp
Ap
Ap
Ap
Ap
Ap
Ap
Ap
Ap
cc
Ap
lp
Ap
Ap
Ap
Ap
Ap
Ap
Ap
Ap
tp
HA
HA
HA
HA
HA
UQ
tp
tp
fB
ci
ci
ci
ci
ci
ci
ci
Sp
ci
ci
PP
RJ
"}
(7,1,1) = {"
Ap
yD
Ap
AL
Ap
BW
Ap
ks
Ap
yD
Ap
Ap
AL
sg
Ap
Ap
BW
Ap
Ap
pC
Ap
Ap
Ap
Ap
tp
Ig
HA
HA
HA
HA
UQ
tp
tp
tp
nz
nz
nz
nz
nz
nz
nz
IB
ci
Rv
kX
RJ
"}
(8,1,1) = {"
Ap
Ap
IJ
Ap
ks
Ap
Ap
Ap
lp
Ap
Ap
Ap
Ap
Ap
Ap
Ap
ks
Ap
vv
Ap
Ap
Ap
ks
Ap
tp
HA
HA
Uz
HA
HA
HA
tp
tp
ci
ci
ci
iw
ci
ci
pO
DX
vp
RJ
RJ
RJ
RJ
"}
(9,1,1) = {"
Ap
Ap
Ap
Ap
Ap
Ap
CJ
Ap
cc
Ap
CJ
Ap
Ap
ks
xH
Ap
cc
Ap
Ap
Ap
Ap
Ap
cc
Ap
GC
HA
HA
HA
HA
HA
HA
iq
ci
ci
ci
vp
vp
Kg
Kg
vp
vp
vp
Ap
Ap
Ap
Ap
"}
(10,1,1) = {"
BW
Ap
Ap
Ap
Ap
Ap
Ap
vv
Ap
Ws
Ap
pC
Ap
Ap
Ap
CJ
Ap
Ap
ks
CJ
Ap
Ap
Ap
Ap
vp
HA
HA
HA
Uq
HA
HA
iq
St
ci
vp
vp
Ap
Ap
Ap
Ap
Ap
Ap
Ap
Ap
Ap
Ap
"}
(11,1,1) = {"
Ap
Ap
Ap
Ap
Ap
Ap
lp
Ap
Ap
ks
Ap
Ap
Ap
Ap
wL
Ap
Ap
Ap
Ap
Ap
AL
Ap
Ap
Ap
vp
vp
vp
Tn
Tn
vp
vp
vp
vp
vp
vp
Ap
Ap
Ap
Ap
Ap
Ap
Ap
Ap
Ap
Ap
Ap
"}
(12,1,1) = {"
Ap
Ap
Ap
Ap
Ap
Ap
Ap
Ap
Ap
Ap
Ap
Ap
Ap
Ap
Ap
yD
Ap
Ap
IJ
Ap
Ap
Ap
Ap
Ap
Ap
bd
Gi
Hc
Hc
Gi
Gi
nf
Ap
Ap
Ap
Ap
Ap
Ap
Ap
Ap
Ap
Ap
Ap
Ap
Ap
Ap
"}
(13,1,1) = {"
Ap
Ap
Ap
Ap
Ap
Ap
Ap
Ap
Ap
Ap
Ap
BW
Ap
ks
Ap
Ap
Ap
Ap
Ap
Ap
Ap
Ap
Ap
Ap
Ap
wX
qO
qO
qO
qO
qO
wS
Ap
Ap
Ap
Ap
Ap
Ap
Ap
Ap
Ap
Ap
Ap
Ap
Ap
Ap
"}
(14,1,1) = {"
Ap
Ap
Ap
Ap
Ap
BW
Ap
Ap
Ap
Ap
Ap
Ap
Ap
Ap
Ap
Ap
Ap
Ap
Ap
Ap
Ap
Ap
Ap
Ap
Ap
Ap
Ap
Ap
Ap
Ap
Ap
Ap
Ap
Ap
Ap
Ap
Ap
Ap
Ap
Ap
Ap
Ap
Ap
Ap
Ap
Ap
"}
