//MAP CONVERTED BY dmm2tgm.py THIS HEADER COMMENT PREVENTS RECONVERSION, DO NOT REMOVE
"da" = (
/turf/open/floor/plating/asteroid/airless,
/area/ruin/space/has_grav/hilbertresearchfacility)
"dN" = (
/obj/structure/table/glass,
/obj/effect/decal/cleanable/dirt,
/turf/open/floor/iron/grimy{
	icon_state = "engine"
	},
/area/ruin/space/has_grav/hilbertresearchfacility)
"ed" = (
/obj/structure/table/glass,
/obj/item/stock_parts/matter_bin/bluespace{
	pixel_y = 7
	},
/turf/open/floor/iron/grimy{
	icon_state = "engine"
	},
/area/ruin/space/has_grav/hilbertresearchfacility)
"fJ" = (
/obj/structure/table/glass,
/obj/item/stock_parts/subspace/crystal{
	pixel_y = 3
	},
/obj/item/stock_parts/subspace/transmitter{
	pixel_y = 3
	},
/turf/open/floor/iron/grimy{
	icon_state = "engine"
	},
/area/ruin/space/has_grav/hilbertresearchfacility)
"gn" = (
/obj/machinery/door/airlock/vault{
	name = "secured door";
	req_access = 207
	},
/obj/effect/mapping_helpers/airlock/locked,
/turf/open/floor/iron/grimy{
	icon_state = "engine"
	},
/area/ruin/space/has_grav/hilbertresearchfacility)
"gJ" = (
/turf/open/floor/iron/stairs/left{
	initial_gas_mix = "TEMP=2.7"
	},
/area/ruin/space/has_grav/hilbertresearchfacility)
"hM" = (
/obj/item/kirbyplants/random,
/turf/open/floor/iron/grimy,
/area/ruin/space/has_grav/hilbertresearchfacility)
"hW" = (
/turf/open/floor/iron/stairs/medium{
	initial_gas_mix = "TEMP=2.7"
	},
/area/ruin/space/has_grav/hilbertresearchfacility)
"jt" = (
/turf/closed/wall/r_wall,
/area/ruin/space/has_grav/hilbertresearchfacility)
"jI" = (
/obj/structure/chair/office,
/obj/effect/decal/cleanable/dirt,
/turf/open/floor/iron/grimy,
/area/ruin/space/has_grav/hilbertresearchfacility)
"jX" = (
/obj/structure/table/glass,
/obj/item/bodybag/bluespace{
	pixel_y = 10
	},
/obj/effect/decal/cleanable/dirt,
/turf/open/floor/iron/grimy{
	icon_state = "engine"
	},
/area/ruin/space/has_grav/hilbertresearchfacility)
"ka" = (
/obj/machinery/porta_turret/syndicate{
	desc = "A ballistic machine gun auto-turret that fires bluespace bullets.";
	lethal_projectile = /obj/projectile/magic/teleport;
	name = "displacement turret";
	stun_projectile = /obj/projectile/magic/teleport
	},
/turf/open/floor/iron/grimy{
	icon_state = "engine"
	},
/area/ruin/space/has_grav/hilbertresearchfacility)
"ld" = (
/turf/closed/mineral/random,
/area/ruin/space/has_grav/hilbertresearchfacility)
"lD" = (
/turf/open/floor/iron/grimy{
	icon_state = "engine"
	},
/area/ruin/space/has_grav/hilbertresearchfacility)
"mh" = (
/obj/structure/table/glass,
/obj/item/slimecross/industrial/bluespace{
	pixel_y = 3
	},
/turf/open/floor/iron/grimy{
	icon_state = "engine"
	},
/area/ruin/space/has_grav/hilbertresearchfacility)
"om" = (
/obj/structure/table/reinforced,
/obj/item/pen,
/turf/open/floor/iron/grimy,
/area/ruin/space/has_grav/hilbertresearchfacility)
"oz" = (
/obj/effect/decal/cleanable/dirt,
/turf/open/floor/iron/grimy{
	icon_state = "engine"
	},
/area/ruin/space/has_grav/hilbertresearchfacility)
"ph" = (
/obj/structure/table/glass,
/obj/item/bag_of_holding_inert,
/obj/effect/decal/cleanable/dirt,
/turf/open/floor/iron/grimy{
	icon_state = "engine"
	},
/area/ruin/space/has_grav/hilbertresearchfacility)
"pl" = (
/obj/machinery/door/airlock/highsecurity{
	req_access = 207
	},
/obj/effect/mapping_helpers/airlock/locked,
/turf/open/floor/iron/grimy,
/area/ruin/space/has_grav/hilbertresearchfacility)
"qj" = (
/obj/effect/decal/cleanable/dirt,
/turf/open/floor/iron/grimy,
/area/ruin/space/has_grav/hilbertresearchfacility)
"rJ" = (
/obj/structure/table/glass,
/obj/item/stack/cable_coil,
/turf/open/floor/iron/grimy{
	icon_state = "engine"
	},
/area/ruin/space/has_grav/hilbertresearchfacility)
"sZ" = (
/turf/open/floor/iron/vaporwave,
/area/ruin/space/has_grav/hilbertresearchfacility)
"wX" = (
/obj/structure/table/glass,
/obj/item/analyzer{
	pixel_x = 2;
	pixel_y = 3
	},
/turf/open/floor/iron/grimy{
	icon_state = "engine"
	},
/area/ruin/space/has_grav/hilbertresearchfacility)
"xR" = (
/obj/structure/table/glass,
/obj/item/raw_anomaly_core/bluespace{
	pixel_y = 7
	},
/obj/effect/decal/cleanable/dirt,
/turf/open/floor/iron/grimy{
	icon_state = "engine"
	},
/area/ruin/space/has_grav/hilbertresearchfacility)
"zk" = (
/obj/structure/table/glass,
/obj/item/reagent_containers/glass/beaker/bluespace{
	pixel_y = 5
	},
/turf/open/floor/iron/grimy{
	icon_state = "engine"
	},
/area/ruin/space/has_grav/hilbertresearchfacility)
"zv" = (
/obj/item/paper/crumpled/docslogs,
/obj/item/pen,
/obj/effect/decal/cleanable/dirt/dust,
/turf/open/floor/iron/vaporwave,
/area/ruin/space/has_grav/hilbertresearchfacility)
"zX" = (
/obj/structure/table/reinforced,
/obj/effect/decal/cleanable/dirt,
/turf/open/floor/iron/grimy,
/area/ruin/space/has_grav/hilbertresearchfacility)
"AJ" = (
/obj/effect/decal/cleanable/dirt/dust,
/turf/open/floor/iron/vaporwave,
/area/ruin/space/has_grav/hilbertresearchfacility)
"BK" = (
/obj/structure/table/glass,
/obj/item/stock_parts/subspace/amplifier{
	pixel_y = 4
	},
/turf/open/floor/iron/grimy{
	icon_state = "engine"
	},
/area/ruin/space/has_grav/hilbertresearchfacility)
"CJ" = (
/turf/open/floor/iron/grimy,
/area/ruin/space/has_grav/hilbertresearchfacility)
"DM" = (
/obj/structure/filingcabinet,
/turf/open/floor/iron/grimy,
/area/ruin/space/has_grav/hilbertresearchfacility)
"Ea" = (
/obj/structure/table/glass,
/obj/item/reagent_containers/syringe/bluespace{
	pixel_y = 5
	},
/obj/effect/decal/cleanable/dirt,
/turf/open/floor/iron/grimy{
	icon_state = "engine"
	},
/area/ruin/space/has_grav/hilbertresearchfacility)
"GF" = (
/turf/open/floor/plating/asteroid/airless,
/area/ruin/unpowered/no_grav)
"Hg" = (
/obj/item/kirbyplants/random,
/obj/effect/decal/cleanable/dirt,
/turf/open/floor/iron/grimy,
/area/ruin/space/has_grav/hilbertresearchfacility)
"Ia" = (
/turf/open/floor/iron/stairs/right{
	initial_gas_mix = "TEMP=2.7"
	},
/area/ruin/space/has_grav/hilbertresearchfacility)
"Iv" = (
/obj/structure/table/glass,
/turf/open/floor/iron/grimy{
	icon_state = "engine"
	},
/area/ruin/space/has_grav/hilbertresearchfacility)
"IL" = (
/turf/open/floor/iron/stairs/left,
/area/ruin/space/has_grav/hilbertresearchfacility)
"Kh" = (
/turf/open/floor/iron/stairs/right,
/area/ruin/space/has_grav/hilbertresearchfacility)
"Lv" = (
/obj/structure/table/reinforced,
/obj/item/paper/crumpled/robertsworkjournal,
/obj/effect/decal/cleanable/dirt,
/turf/open/floor/iron/grimy,
/area/ruin/space/has_grav/hilbertresearchfacility)
"Mk" = (
/obj/structure/table/glass,
/obj/item/stack/sheet/bluespace_crystal{
	amount = 37;
	pixel_x = 2;
	pixel_y = 1
	},
/turf/open/floor/iron/grimy{
	icon_state = "engine"
	},
/area/ruin/space/has_grav/hilbertresearchfacility)
"MG" = (
/obj/structure/table/reinforced,
/turf/open/floor/iron/grimy,
/area/ruin/space/has_grav/hilbertresearchfacility)
"Pp" = (
/turf/open/floor/iron/stairs/medium,
/area/ruin/space/has_grav/hilbertresearchfacility)
"PT" = (
/turf/closed/mineral/random,
/area/ruin/unpowered/no_grav)
"Qt" = (
/obj/machinery/door/window/eastleft,
/turf/open/floor/iron/grimy,
/area/ruin/space/has_grav/hilbertresearchfacility)
"RD" = (
/turf/closed/wall/r_wall/rust,
/area/ruin/space/has_grav/hilbertresearchfacility)
"SU" = (
/obj/structure/displaycase{
	start_showpiece_type = /obj/item/hilbertshotel
	},
/obj/effect/decal/cleanable/dirt/dust,
/turf/open/floor/iron/vaporwave,
/area/ruin/space/has_grav/hilbertresearchfacility)
"Vi" = (
/obj/structure/table/glass,
/obj/item/assembly/signaler{
	pixel_y = 6
	},
/turf/open/floor/iron/grimy{
	icon_state = "engine"
	},
/area/ruin/space/has_grav/hilbertresearchfacility)
"Yv" = (
/turf/open/space/basic,
/area/template_noop)

(1,1,1) = {"
Yv
Yv
Yv
Yv
Yv
Yv
Yv
Yv
Yv
Yv
ld
Yv
Yv
Yv
Yv
Yv
Yv
Yv
Yv
Yv
Yv
Yv
Yv
"}
(2,1,1) = {"
Yv
Yv
ld
da
ld
da
da
Yv
GF
PT
GF
da
da
Yv
Yv
Yv
Yv
Yv
Yv
Yv
Yv
Yv
Yv
"}
(3,1,1) = {"
Yv
da
ld
ld
ld
da
ld
GF
PT
GF
GF
ld
ld
ld
Yv
Yv
Yv
Yv
Yv
Yv
Yv
Yv
Yv
"}
(4,1,1) = {"
Yv
GF
RD
RD
RD
RD
RD
jt
jt
RD
jt
jt
RD
jt
jt
Yv
Yv
Yv
Yv
Yv
Yv
Yv
Yv
"}
(5,1,1) = {"
Yv
GF
jt
ka
lD
oz
Ea
zk
Iv
Iv
lD
oz
oz
ka
RD
da
da
da
da
da
Yv
Yv
Yv
"}
(6,1,1) = {"
Yv
ld
jt
oz
oz
oz
oz
oz
oz
oz
oz
oz
lD
lD
RD
jt
jt
RD
jt
RD
ld
Yv
Yv
"}
(7,1,1) = {"
Yv
ld
RD
oz
oz
oz
oz
oz
oz
oz
oz
oz
oz
oz
RD
DM
CJ
MG
Hg
RD
ld
Yv
Yv
"}
(8,1,1) = {"
Yv
ld
RD
Iv
oz
lD
ed
fJ
BK
lD
oz
oz
oz
oz
jt
CJ
qj
om
qj
RD
ld
ld
Yv
"}
(9,1,1) = {"
Yv
ld
RD
Iv
oz
IL
AJ
sZ
sZ
IL
lD
oz
oz
oz
jt
CJ
jI
Lv
qj
jt
gJ
da
Yv
"}
(10,1,1) = {"
Yv
ld
RD
Mk
oz
Pp
AJ
SU
sZ
Pp
oz
oz
oz
oz
RD
qj
qj
zX
qj
pl
hW
da
Yv
"}
(11,1,1) = {"
Yv
ld
RD
Iv
oz
Kh
AJ
AJ
zv
Kh
lD
oz
oz
oz
RD
zX
Qt
MG
qj
jt
Ia
da
Yv
"}
(12,1,1) = {"
Yv
ld
RD
jX
oz
oz
rJ
wX
Vi
lD
oz
oz
oz
oz
jt
hM
qj
CJ
qj
jt
da
da
da
"}
(13,1,1) = {"
da
ld
RD
oz
oz
oz
lD
lD
oz
oz
lD
oz
oz
lD
gn
CJ
CJ
qj
qj
RD
da
da
da
"}
(14,1,1) = {"
da
ld
jt
oz
oz
oz
oz
oz
lD
oz
lD
oz
oz
oz
jt
jt
jt
RD
RD
RD
da
da
da
"}
(15,1,1) = {"
da
ld
jt
ka
oz
xR
ph
Iv
mh
dN
oz
oz
oz
ka
RD
ld
ld
ld
da
da
da
ld
da
"}
(16,1,1) = {"
da
ld
RD
RD
RD
RD
RD
RD
jt
jt
RD
RD
RD
jt
RD
da
da
ld
ld
ld
ld
ld
ld
"}
(17,1,1) = {"
Yv
da
ld
da
da
ld
ld
ld
da
da
da
da
ld
da
da
da
Yv
Yv
ld
ld
Yv
Yv
Yv
"}
(18,1,1) = {"
Yv
da
ld
ld
da
da
da
da
da
ld
ld
da
da
da
Yv
Yv
Yv
Yv
Yv
Yv
Yv
Yv
Yv
"}
(19,1,1) = {"
Yv
da
da
ld
ld
da
ld
ld
da
da
ld
ld
da
da
Yv
Yv
Yv
Yv
Yv
Yv
Yv
Yv
Yv
"}
(20,1,1) = {"
Yv
Yv
Yv
da
da
da
Yv
Yv
ld
ld
ld
Yv
Yv
Yv
Yv
Yv
Yv
Yv
Yv
Yv
Yv
Yv
Yv
"}
