//MAP CONVERTED BY dmm2tgm.py THIS HEADER COMMENT PREVENTS RECONVERSION, DO NOT REMOVE
"a" = (
/turf/open/space/basic,
/area/template_noop)
"d" = (
/turf/open/floor/mineral/titanium/airless,
/area/ruin/unpowered)
"e" = (
/obj/effect/mapping_helpers/smart_pipe/manifold4w/orange/hidden,
/obj/machinery/power/terminal,
/obj/structure/cable,
/turf/open/floor/mineral/titanium/airless,
/area/ruin/unpowered)
"j" = (
/obj/machinery/power/smes/engineering{
	charge = 0
	},
/turf/open/floor/mineral/titanium/airless,
/area/ruin/unpowered)
"k" = (
/turf/closed/mineral/random,
/area/template_noop)
"l" = (
/obj/machinery/atmospherics/components/unary/engine,
/turf/closed/wall/mineral/titanium,
/area/ruin/unpowered)
"m" = (
/obj/effect/mob_spawn/human/corpse/cargo_tech,
/obj/effect/decal/cleanable/blood/old,
/turf/open/floor/mineral/titanium/airless,
/area/ruin/unpowered)
"n" = (
/obj/effect/decal/cleanable/blood/footprints{
	dir = 4;
	pixel_x = 2;
	pixel_y = 8
	},
/obj/effect/decal/cleanable/blood/footprints{
	dir = 4;
	pixel_x = 13;
	pixel_y = 6
	},
/turf/open/floor/mineral/titanium/airless,
/area/ruin/unpowered)
"o" = (
/obj/machinery/door/airlock/external{
	dir = 4
	},
/turf/open/floor/mineral/titanium/airless,
/area/ruin/unpowered)
"p" = (
/obj/effect/decal/cleanable/glass,
/obj/structure/frame/computer,
/turf/open/floor/mineral/titanium/airless,
/area/ruin/unpowered)
"q" = (
/obj/structure/closet/crate,
/obj/effect/spawner/lootdrop/material,
/obj/effect/spawner/lootdrop/material,
/obj/effect/spawner/lootdrop/material,
/obj/effect/spawner/lootdrop/material,
/obj/effect/spawner/lootdrop/material,
/obj/effect/spawner/lootdrop/material,
/turf/open/floor/mineral/titanium/airless,
/area/ruin/unpowered)
"t" = (
/turf/closed/wall/mineral/titanium,
/area/ruin/unpowered)
"v" = (
/obj/effect/decal/cleanable/plasma,
/obj/effect/decal/cleanable/ash/large,
/turf/open/floor/plating/asteroid/airless,
/area/template_noop)
"w" = (
/obj/effect/decal/cleanable/plasma,
/obj/effect/decal/cleanable/ash,
/turf/open/floor/plating/asteroid/airless,
/area/template_noop)
"y" = (
/obj/structure/closet/excavation,
/turf/open/floor/mineral/titanium/airless,
/area/ruin/unpowered)
"A" = (
/obj/structure/cable,
/turf/open/floor/mineral/titanium/airless,
/area/ruin/unpowered)
"E" = (
/obj/structure/shuttle/engine/heater,
/obj/structure/window/reinforced{
	dir = 1;
	pixel_y = 2
	},
/obj/structure/window/reinforced{
	dir = 4;
	layer = 2.9
	},
/turf/open/floor/mineral/titanium/airless,
/area/ruin/unpowered)
"G" = (
/obj/machinery/airalarm/directional/west,
/turf/open/floor/mineral/titanium/airless,
/area/ruin/unpowered)
"J" = (
/obj/structure/window/reinforced/fulltile,
/obj/structure/low_wall/titanium,
/turf/open/floor/mineral/titanium/airless,
/area/ruin/unpowered)
"L" = (
/turf/closed/mineral/random,
/area/ruin/unpowered)
"M" = (
/obj/effect/mapping_helpers/smart_pipe/manifold4w/orange/hidden,
/turf/open/floor/mineral/titanium/airless,
/area/ruin/unpowered)
"P" = (
/obj/machinery/power/apc/auto_name/west{
	locked = 0
	},
/obj/structure/cable,
/turf/open/floor/mineral/titanium/airless,
/area/ruin/unpowered)
"S" = (
/obj/structure/shuttle/engine/heater,
/obj/structure/window/reinforced{
	dir = 1;
	pixel_y = 2
	},
/obj/structure/window/reinforced{
	dir = 8
	},
/turf/open/floor/mineral/titanium/airless,
/area/ruin/unpowered)
"T" = (
/obj/machinery/atmospherics/components/unary/portables_connector/visible{
	dir = 1
	},
/obj/machinery/portable_atmospherics/canister/carbon_dioxide,
/turf/open/floor/mineral/titanium/airless,
/area/ruin/unpowered)
"U" = (
/obj/effect/decal/cleanable/glass,
/turf/open/floor/mineral/titanium/airless,
/area/ruin/unpowered)
"W" = (
/obj/machinery/shuttle_comms/active{
	pixel_y = 4
	},
/obj/structure/table/reinforced,
/obj/effect/decal/cleanable/glass,
/turf/open/floor/mineral/titanium/airless,
/area/ruin/unpowered)
"Y" = (
/obj/structure/chair/comfy/shuttle{
	dir = 1
	},
/obj/effect/decal/cleanable/glass,
/obj/effect/decal/cleanable/blood/old,
/turf/open/floor/mineral/titanium/airless,
/area/ruin/unpowered)
"Z" = (
/obj/effect/decal/cleanable/plasma,
/turf/open/floor/plating/asteroid/airless,
/area/template_noop)

(1,1,1) = {"
a
a
a
a
k
a
a
a
a
a
a
a
a
a
a
a
a
a
a
a
a
a
a
"}
(2,1,1) = {"
a
k
k
k
k
k
k
a
a
a
a
a
a
a
a
a
a
a
a
a
a
a
a
"}
(3,1,1) = {"
a
k
k
k
k
k
k
k
k
a
a
a
a
a
a
a
a
a
a
a
a
a
a
"}
(4,1,1) = {"
k
k
k
k
k
k
k
k
k
a
a
a
a
a
a
a
a
a
a
a
a
a
a
"}
(5,1,1) = {"
k
k
k
k
k
k
k
Z
Z
a
a
a
a
a
t
t
t
t
t
o
t
t
t
"}
(6,1,1) = {"
k
k
k
k
k
k
Z
Z
Z
w
a
a
a
a
J
U
d
G
P
d
M
E
l
"}
(7,1,1) = {"
k
k
k
k
k
k
Z
Z
w
v
a
a
k
k
L
p
Y
d
A
d
M
T
t
"}
(8,1,1) = {"
k
k
k
k
k
k
Z
Z
Z
w
a
a
k
k
J
W
n
d
A
A
e
j
t
"}
(9,1,1) = {"
k
k
k
k
k
k
k
Z
Z
Z
a
a
a
a
J
y
m
q
q
d
M
S
l
"}
(10,1,1) = {"
k
k
k
k
k
k
k
k
Z
Z
a
a
a
a
t
t
t
t
t
o
t
t
t
"}
(11,1,1) = {"
k
k
k
k
k
k
k
k
k
k
a
a
a
a
a
a
a
a
a
a
a
a
a
"}
(12,1,1) = {"
k
k
k
k
k
k
k
k
k
a
a
a
a
a
a
a
a
a
a
a
a
a
a
"}
(13,1,1) = {"
a
k
k
k
k
k
k
k
k
a
a
a
a
a
a
a
a
a
a
a
a
a
a
"}
(14,1,1) = {"
a
k
k
k
k
k
k
k
k
a
a
a
a
a
a
a
a
a
a
a
a
a
a
"}
(15,1,1) = {"
a
a
a
k
k
k
k
k
a
a
a
a
a
a
a
a
a
a
a
a
a
a
a
"}
(16,1,1) = {"
a
a
a
a
a
a
a
a
a
a
a
a
a
a
a
a
a
a
a
a
a
a
a
"}
