//MAP CONVERTED BY dmm2tgm.py THIS HEADER COMMENT PREVENTS RECONVERSION, DO NOT REMOVE
"a" = (
/turf/template_noop,
/area/template_noop)
"b" = (
/turf/closed/mineral/random,
/area/ruin/space/way_home)
"c" = (
/turf/open/floor/plating/asteroid/airless,
/area/ruin/space/way_home)
"d" = (
/obj/structure/signpost/salvation,
/turf/open/floor/plating/asteroid/airless,
/area/ruin/space/way_home)
"h" = (
/turf/open/floor/plating/asteroid,
/area/ruin/space/way_home)
"l" = (
/obj/item/food/rationpack,
/turf/open/floor/plating/asteroid,
/area/ruin/space/way_home)
"m" = (
/obj/structure/chair/plastic,
/turf/open/floor/plating/asteroid,
/area/ruin/space/way_home)
"o" = (
/obj/structure/chair/plastic{
	dir = 8
	},
/turf/open/floor/plating/asteroid,
/area/ruin/space/way_home)
"z" = (
/obj/structure/holosign/barrier/atmos,
/turf/open/floor/plating/asteroid/airless,
/area/ruin/space/way_home)
"A" = (
/obj/item/clothing/suit/space,
/obj/item/clothing/head/helmet/space/eva,
/turf/open/floor/plating/asteroid,
/area/ruin/space/way_home)
"B" = (
/obj/effect/decal/remains/human,
/turf/open/floor/plating/asteroid,
/area/ruin/space/way_home)
"E" = (
/obj/item/tank/internals/oxygen/empty,
/obj/item/clothing/mask/breath,
/turf/open/floor/plating/asteroid,
/area/ruin/space/way_home)
"S" = (
/obj/structure/bonfire,
/turf/open/floor/plating/asteroid,
/area/ruin/space/way_home)

(1,1,1) = {"
a
a
a
a
a
a
a
a
a
a
a
a
a
a
a
a
a
a
a
a
a
b
b
a
"}
(2,1,1) = {"
a
a
a
b
b
a
a
a
a
a
a
a
a
a
a
a
a
a
a
a
a
b
b
b
"}
(3,1,1) = {"
a
a
b
b
b
a
a
a
a
a
a
b
a
a
a
a
a
a
a
a
a
a
b
a
"}
(4,1,1) = {"
a
a
b
b
b
a
a
a
a
a
a
a
a
a
a
a
a
a
a
a
a
a
a
a
"}
(5,1,1) = {"
a
a
a
b
a
a
a
a
a
b
b
a
a
a
a
b
b
a
a
a
a
a
a
a
"}
(6,1,1) = {"
a
a
a
a
a
a
a
b
b
b
b
b
b
a
a
b
b
b
a
a
a
a
a
a
"}
(7,1,1) = {"
a
a
a
a
a
a
b
b
b
b
b
b
b
a
a
c
c
a
a
a
a
b
a
a
"}
(8,1,1) = {"
a
a
a
a
b
b
b
b
b
b
b
b
a
a
a
a
a
a
a
a
a
a
a
a
"}
(9,1,1) = {"
a
b
a
b
b
b
b
b
b
c
c
c
a
a
a
a
a
a
a
a
a
a
a
a
"}
(10,1,1) = {"
a
b
b
b
b
b
b
b
c
c
b
c
c
a
a
a
a
a
a
a
a
a
a
a
"}
(11,1,1) = {"
a
b
b
b
A
E
b
c
c
b
c
c
c
a
a
a
a
a
a
b
b
a
a
a
"}
(12,1,1) = {"
b
b
l
h
h
h
z
c
c
b
c
c
c
c
c
c
a
a
b
b
b
b
a
a
"}
(13,1,1) = {"
b
b
h
m
S
B
b
b
b
b
c
c
c
c
c
c
c
b
b
b
b
b
a
a
"}
(14,1,1) = {"
b
b
h
h
o
h
b
b
b
b
a
a
c
c
d
c
c
b
b
b
b
b
a
a
"}
(15,1,1) = {"
a
b
b
b
h
h
b
b
b
a
a
a
a
c
c
c
b
b
b
b
b
b
a
a
"}
(16,1,1) = {"
a
b
b
b
b
b
b
b
a
a
c
c
a
a
c
c
c
b
b
b
b
b
a
a
"}
(17,1,1) = {"
a
b
b
a
a
b
b
b
a
c
c
b
b
a
a
c
c
c
b
b
b
b
a
a
"}
(18,1,1) = {"
a
a
a
a
a
a
b
a
a
b
c
b
b
b
a
a
c
c
c
b
b
b
a
a
"}
(19,1,1) = {"
a
a
a
a
a
a
a
a
a
a
a
a
a
a
a
a
a
a
c
b
a
a
a
a
"}
