//MAP CONVERTED BY dmm2tgm.py THIS HEADER COMMENT PREVENTS RECONVERSION, DO NOT REMOVE
"aa" = (
/obj/effect/decal/cleanable/dirt,
/obj/effect/turf_decal/bot,
/obj/effect/spawner/lootdrop/maintenance/five,
/obj/structure/closet/crate,
/turf/open/floor/iron,
/area/shuttle/vulture)
"ac" = (
/obj/effect/decal/cleanable/dirt,
/obj/machinery/power/apc/auto_name/east,
/obj/effect/mapping_helpers/smart_pipe/manifold4w/scrubbers/hidden/layer2{
	dir = 6
	},
/obj/structure/cable,
/turf/open/floor/pod,
/area/shuttle/vulture/helm)
"am" = (
/obj/effect/decal/cleanable/dirt,
/obj/structure/lattice/catwalk/plated,
/obj/machinery/atmospherics/components/binary/pump/layer4,
/turf/open/floor/plating,
/area/shuttle/vulture)
"ar" = (
/obj/structure/closet/emcloset/anchored,
/turf/open/floor/iron,
/area/shuttle/vulture)
"aL" = (
/obj/effect/mapping_helpers/smart_pipe/manifold4w/scrubbers/hidden/layer2{
	dir = 6
	},
/obj/effect/mapping_helpers/smart_pipe/manifold4w/supply/hidden/layer4{
	dir = 6
	},
/obj/effect/decal/cleanable/dirt,
/turf/open/floor/iron,
/area/shuttle/vulture)
"bR" = (
/obj/structure/chair/wood{
	dir = 1
	},
/obj/effect/mapping_helpers/smart_pipe/manifold4w/supply/hidden/layer4{
	dir = 6
	},
/turf/open/floor/carpet,
/area/shuttle/vulture/dorm)
"de" = (
/obj/effect/decal/cleanable/dirt,
/obj/machinery/atmospherics/components/binary/pump{
	dir = 8
	},
/turf/open/floor/iron,
/area/shuttle/vulture)
"do" = (
/obj/effect/decal/cleanable/dirt,
/obj/machinery/portable_atmospherics/canister,
/obj/structure/lattice/catwalk/plated,
/obj/machinery/atmospherics/components/unary/portables_connector/visible/layer2,
/turf/open/floor/plating,
/area/shuttle/vulture)
"dE" = (
/obj/effect/decal/cleanable/dirt,
/obj/machinery/door/firedoor,
/obj/machinery/power/terminal,
/obj/structure/cable,
/obj/structure/rack,
/obj/item/stack/sheet/iron/twenty,
/obj/item/stack/sheet/glass{
	amount = 30
	},
/obj/item/flashlight,
/obj/effect/turf_decal/stripes/line,
/obj/effect/mapping_helpers/smart_pipe/manifold4w/supply/hidden/layer4{
	dir = 6
	},
/obj/structure/lattice/catwalk/plated,
/obj/machinery/light/directional/east,
/turf/open/floor/plating,
/area/shuttle/vulture)
"ee" = (
/obj/effect/decal/cleanable/dirt,
/obj/structure/cable,
/obj/structure/sign/poster/random{
	pixel_y = 32
	},
/turf/open/floor/iron,
/area/shuttle/vulture)
"el" = (
/obj/machinery/atmospherics/components/unary/vent_scrubber/on/layer2{
	dir = 8
	},
/turf/open/floor/iron,
/area/shuttle/vulture)
"er" = (
/obj/structure/table/wood,
/obj/machinery/light/small/directional/west,
/obj/machinery/atmospherics/components/unary/vent_pump/on/layer4,
/turf/open/floor/carpet,
/area/shuttle/vulture/dorm)
"eN" = (
/obj/effect/decal/cleanable/dirt,
/obj/effect/mapping_helpers/smart_pipe/manifold4w/scrubbers/hidden/layer2{
	dir = 6
	},
/obj/effect/mapping_helpers/smart_pipe/manifold4w/supply/hidden/layer4{
	dir = 6
	},
/obj/structure/cable,
/turf/open/floor/pod,
/area/shuttle/vulture/helm)
"ff" = (
/obj/structure/table,
/obj/item/food/canned/beans,
/obj/item/kitchen/fork,
/turf/open/floor/iron,
/area/shuttle/vulture)
"fq" = (
/obj/structure/closet/crate/bin,
/obj/effect/decal/cleanable/dirt,
/obj/effect/spawner/lootdrop/away_loot,
/obj/effect/mapping_helpers/smart_pipe/manifold4w/supply/hidden/layer4{
	dir = 6
	},
/obj/machinery/power/apc/auto_name/east,
/obj/structure/cable,
/turf/open/floor/iron,
/area/shuttle/vulture)
"fG" = (
/obj/effect/mapping_helpers/smart_pipe/manifold4w/scrubbers/hidden/layer2{
	dir = 6
	},
/obj/effect/mapping_helpers/smart_pipe/manifold4w/supply/hidden/layer4{
	dir = 6
	},
/obj/structure/cable,
/turf/open/floor/iron,
/area/shuttle/vulture)
"fK" = (
/obj/effect/turf_decal/bot,
/obj/effect/decal/cleanable/dirt,
/obj/effect/mapping_helpers/smart_pipe/manifold4w/orange/visible,
/obj/structure/reagent_dispensers/fueltank,
/turf/open/floor/iron,
/area/shuttle/vulture)
"fT" = (
/obj/effect/decal/cleanable/dirt,
/obj/effect/turf_decal/bot,
/turf/open/floor/iron,
/area/shuttle/vulture)
"gl" = (
/obj/effect/decal/cleanable/dirt,
/obj/machinery/power/port_gen/pacman{
	anchored = 1
	},
/obj/structure/cable,
/obj/item/stack/sheet/mineral/plasma/five,
/obj/item/stack/sheet/mineral/plasma/five,
/obj/effect/mapping_helpers/smart_pipe/manifold4w/supply/hidden/layer4{
	dir = 6
	},
/obj/structure/lattice/catwalk/plated,
/turf/open/floor/plating,
/area/shuttle/vulture)
"hl" = (
/obj/effect/turf_decal/bot,
/obj/effect/decal/cleanable/dirt,
/obj/machinery/portable_atmospherics/canister/carbon_dioxide,
/obj/machinery/atmospherics/components/unary/portables_connector/visible{
	dir = 8
	},
/turf/open/floor/iron,
/area/shuttle/vulture)
"hr" = (
/obj/effect/decal/cleanable/dirt,
/obj/structure/toilet{
	dir = 8
	},
/obj/machinery/atmospherics/components/unary/vent_scrubber/on/layer2{
	dir = 8
	},
/turf/open/floor/iron/freezer,
/area/shuttle/vulture)
"hY" = (
/obj/machinery/door/airlock/external/glass,
/obj/machinery/door/firedoor,
/obj/effect/mapping_helpers/airlock/cyclelink_helper{
	dir = 8
	},
/obj/structure/lattice/catwalk/plated,
/obj/effect/mapping_helpers/smart_pipe/manifold4w/supply/hidden/layer4{
	dir = 6
	},
/obj/effect/mapping_helpers/smart_pipe/manifold4w/scrubbers/hidden/layer2{
	dir = 6
	},
/turf/open/floor/plating,
/area/shuttle/vulture)
"iu" = (
/obj/effect/decal/cleanable/dirt,
/obj/effect/turf_decal/bot,
/obj/structure/ore_box,
/obj/item/storage/bag/ore,
/turf/open/floor/iron,
/area/shuttle/vulture)
"iS" = (
/obj/effect/spawner/structure/window/shuttle,
/turf/open/floor/plating,
/area/shuttle/vulture/dorm)
"jB" = (
/obj/machinery/atmospherics/components/unary/engine,
/turf/closed/wall/mineral/titanium,
/area/shuttle/vulture)
"lK" = (
/obj/structure/bed,
/obj/item/bedsheet/dorms,
/obj/machinery/atmospherics/components/unary/vent_scrubber/on/layer2{
	dir = 4
	},
/turf/open/floor/carpet,
/area/shuttle/vulture/dorm)
"mg" = (
/obj/machinery/door/airlock/external/glass,
/obj/structure/fans/tiny,
/obj/docking_port/mobile{
	dir = 4;
	dwidth = 7;
	height = 11;
	id = "vulture";
	launch_status = 0;
	name = "MS Vulture";
	port_direction = 8;
	width = 15
	},
/obj/effect/mapping_helpers/airlock/cyclelink_helper{
	dir = 4
	},
/obj/structure/lattice/catwalk/plated,
/turf/open/floor/plating,
/area/shuttle/vulture)
"mA" = (
/obj/effect/decal/cleanable/dirt,
/obj/item/storage/firstaid/regular,
/obj/structure/table,
/turf/open/floor/pod,
/area/shuttle/vulture/helm)
"mB" = (
/obj/structure/table,
/obj/effect/mapping_helpers/smart_pipe/manifold4w/scrubbers/hidden/layer2{
	dir = 6
	},
/obj/effect/mapping_helpers/smart_pipe/manifold4w/supply/hidden/layer4{
	dir = 6
	},
/obj/item/storage/cans/sixsoda,
/turf/open/floor/iron,
/area/shuttle/vulture)
"nz" = (
/obj/effect/mapping_helpers/smart_pipe/manifold4w/scrubbers/hidden/layer2{
	dir = 6
	},
/obj/effect/mapping_helpers/smart_pipe/manifold4w/supply/hidden/layer4{
	dir = 6
	},
/obj/effect/turf_decal/bot,
/turf/open/floor/iron,
/area/shuttle/vulture)
"nC" = (
/turf/closed/wall/mineral/titanium,
/area/shuttle/vulture/helm)
"nF" = (
/obj/effect/mapping_helpers/smart_pipe/manifold4w/scrubbers/hidden/layer2{
	dir = 6
	},
/obj/effect/mapping_helpers/smart_pipe/manifold4w/supply/hidden/layer4{
	dir = 6
	},
/obj/structure/cable,
/turf/open/floor/carpet,
/area/shuttle/vulture/dorm)
"nJ" = (
/obj/effect/decal/cleanable/dirt,
/obj/machinery/firealarm/directional/west,
/obj/structure/chair/comfy/shuttle{
	dir = 4
	},
/obj/machinery/light/directional/west,
/turf/open/floor/iron,
/area/shuttle/vulture)
"oz" = (
/obj/effect/decal/cleanable/dirt,
/obj/effect/mapping_helpers/smart_pipe/manifold4w/scrubbers/hidden/layer2{
	dir = 6
	},
/obj/effect/mapping_helpers/smart_pipe/manifold4w/supply/hidden/layer4{
	dir = 6
	},
/turf/open/floor/iron,
/area/shuttle/vulture)
"pE" = (
/obj/effect/spawner/lootdrop/maintenance,
/obj/effect/decal/cleanable/dirt,
/obj/structure/mirror/directional/west,
/obj/structure/sink{
	dir = 4;
	pixel_x = -12
	},
/obj/effect/mapping_helpers/smart_pipe/manifold4w/scrubbers/hidden/layer2{
	dir = 6
	},
/obj/effect/mapping_helpers/smart_pipe/manifold4w/supply/hidden/layer4{
	dir = 6
	},
/turf/open/floor/iron/freezer,
/area/shuttle/vulture)
"pG" = (
/obj/effect/decal/cleanable/dirt,
/obj/effect/mapping_helpers/smart_pipe/manifold4w/supply/hidden/layer4{
	dir = 6
	},
/obj/effect/mapping_helpers/smart_pipe/manifold4w/scrubbers/hidden/layer2{
	dir = 6
	},
/turf/open/floor/iron,
/area/shuttle/vulture)
"rk" = (
/obj/effect/decal/cleanable/dirt,
/obj/machinery/portable_atmospherics/canister/air,
/obj/structure/lattice/catwalk/plated,
/obj/machinery/atmospherics/components/unary/portables_connector/visible/layer4,
/turf/open/floor/plating,
/area/shuttle/vulture)
"ry" = (
/obj/effect/decal/cleanable/dirt,
/obj/machinery/light/small/directional/west,
/obj/structure/lattice/catwalk/plated,
/obj/machinery/atmospherics/components/binary/pump/layer2{
	dir = 1
	},
/turf/open/floor/plating,
/area/shuttle/vulture)
"rI" = (
/obj/effect/decal/cleanable/dirt,
/obj/effect/mapping_helpers/smart_pipe/manifold4w/scrubbers/hidden/layer2{
	dir = 6
	},
/obj/effect/mapping_helpers/smart_pipe/manifold4w/supply/hidden/layer4{
	dir = 6
	},
/obj/structure/cable,
/turf/open/floor/iron,
/area/shuttle/vulture)
"so" = (
/obj/machinery/door/airlock,
/obj/effect/decal/cleanable/dirt,
/obj/machinery/door/firedoor,
/obj/effect/mapping_helpers/smart_pipe/manifold4w/scrubbers/hidden/layer2{
	dir = 6
	},
/obj/effect/mapping_helpers/smart_pipe/manifold4w/supply/hidden/layer4{
	dir = 6
	},
/turf/open/floor/iron/freezer,
/area/shuttle/vulture)
"sr" = (
/obj/machinery/power/apc/auto_name/east,
/obj/machinery/light_switch/directional/south,
/obj/effect/mapping_helpers/smart_pipe/manifold4w/scrubbers/hidden/layer2{
	dir = 6
	},
/obj/effect/mapping_helpers/smart_pipe/manifold4w/supply/hidden/layer4{
	dir = 6
	},
/obj/structure/cable,
/turf/open/floor/carpet,
/area/shuttle/vulture/dorm)
"tS" = (
/obj/effect/mapping_helpers/smart_pipe/manifold4w/scrubbers/hidden/layer2{
	dir = 6
	},
/obj/structure/cable,
/turf/open/floor/iron,
/area/shuttle/vulture)
"vF" = (
/obj/structure/table,
/obj/effect/spawner/lootdrop/donkpockets,
/obj/effect/decal/cleanable/dirt,
/obj/structure/closet/mini_fridge,
/obj/item/reagent_containers/food/drinks/waterbottle,
/obj/item/reagent_containers/food/drinks/waterbottle,
/turf/open/floor/iron,
/area/shuttle/vulture)
"vS" = (
/obj/effect/decal/cleanable/dirt,
/obj/machinery/computer/shuttle/common_docks,
/turf/open/floor/pod,
/area/shuttle/vulture/helm)
"wA" = (
/obj/structure/chair/stool/bar{
	dir = 8
	},
/turf/open/floor/iron,
/area/shuttle/vulture)
"xG" = (
/obj/structure/shuttle/engine/heater,
/obj/structure/window/reinforced{
	dir = 1
	},
/obj/effect/mapping_helpers/smart_pipe/manifold4w/orange/visible,
/turf/open/floor/plating,
/area/shuttle/vulture)
"ze" = (
/obj/effect/turf_decal/bot,
/obj/effect/decal/cleanable/dirt,
/obj/effect/mapping_helpers/smart_pipe/manifold4w/scrubbers/hidden/layer2{
	dir = 6
	},
/obj/effect/mapping_helpers/smart_pipe/manifold4w/supply/hidden/layer4{
	dir = 6
	},
/obj/structure/reagent_dispensers/watertank,
/obj/item/reagent_containers/glass/bucket,
/obj/item/mop,
/turf/open/floor/iron,
/area/shuttle/vulture)
"zR" = (
/obj/effect/turf_decal/stripes/line{
	dir = 8
	},
/obj/structure/lattice/catwalk/plated,
/obj/effect/mapping_helpers/smart_pipe/manifold4w/scrubbers/hidden/layer2{
	dir = 6
	},
/obj/machinery/atmospherics/components/unary/vent_pump/on/layer4{
	dir = 4
	},
/turf/open/floor/plating,
/area/shuttle/vulture)
"AU" = (
/obj/structure/chair/comfy/shuttle{
	dir = 1
	},
/turf/open/floor/pod,
/area/shuttle/vulture/helm)
"Bl" = (
/obj/structure/closet/crate,
/obj/effect/spawner/lootdrop/maintenance,
/obj/effect/decal/cleanable/dirt,
/obj/effect/turf_decal/bot,
/turf/open/floor/iron,
/area/shuttle/vulture)
"Cu" = (
/obj/machinery/atmospherics/components/unary/vent_pump/on/layer4,
/turf/open/floor/iron,
/area/shuttle/vulture)
"CN" = (
/obj/structure/table,
/obj/machinery/microwave,
/obj/effect/decal/cleanable/dirt,
/turf/open/floor/iron,
/area/shuttle/vulture)
"ES" = (
/obj/effect/turf_decal/bot,
/obj/effect/decal/cleanable/dirt,
/obj/machinery/portable_atmospherics/canister/oxygen,
/turf/open/floor/iron,
/area/shuttle/vulture)
"FD" = (
/obj/effect/decal/cleanable/dirt,
/obj/machinery/transporter,
/obj/effect/turf_decal/box,
/turf/open/floor/iron,
/area/shuttle/vulture)
"Gu" = (
/obj/effect/decal/cleanable/dirt,
/obj/machinery/atmospherics/components/unary/vent_scrubber/on/layer2{
	dir = 1
	},
/turf/open/floor/iron,
/area/shuttle/vulture)
"GS" = (
/obj/machinery/light/directional/south,
/turf/open/floor/iron,
/area/shuttle/vulture)
"HJ" = (
/obj/effect/decal/cleanable/dirt,
/obj/machinery/power/smes/engineering{
	charge = 1e+006
	},
/obj/effect/mapping_helpers/smart_pipe/manifold4w/supply/hidden/layer4{
	dir = 6
	},
/obj/structure/cable,
/obj/structure/sign/warning/electricshock{
	pixel_x = 32
	},
/obj/structure/lattice/catwalk/plated,
/turf/open/floor/plating,
/area/shuttle/vulture)
"Jw" = (
/obj/effect/decal/cleanable/dirt,
/obj/effect/mapping_helpers/smart_pipe/manifold4w/scrubbers/hidden/layer2{
	dir = 6
	},
/obj/structure/lattice/catwalk/plated,
/turf/open/floor/plating,
/area/shuttle/vulture)
"JK" = (
/obj/effect/decal/cleanable/dirt,
/obj/effect/decal/cleanable/blood/old,
/obj/machinery/light/small/directional/west,
/obj/effect/mapping_helpers/smart_pipe/manifold4w/supply/hidden/layer4{
	dir = 6
	},
/turf/open/floor/iron/freezer,
/area/shuttle/vulture)
"KO" = (
/obj/machinery/airalarm/directional/east,
/obj/structure/closet/secure_closet/personal/cabinet,
/turf/open/floor/carpet,
/area/shuttle/vulture/dorm)
"Ld" = (
/obj/machinery/airalarm/directional/west,
/obj/structure/chair/comfy/shuttle{
	dir = 4
	},
/turf/open/floor/iron,
/area/shuttle/vulture)
"Ll" = (
/turf/template_noop,
/area/template_noop)
"Ls" = (
/obj/effect/spawner/structure/window/shuttle,
/obj/machinery/door/poddoor/shutters/preopen{
	id = "vulture_shutter"
	},
/turf/open/floor/plating,
/area/shuttle/vulture)
"LP" = (
/obj/machinery/atmospherics/components/unary/vent_pump/on/layer4{
	dir = 8
	},
/obj/structure/cable,
/turf/open/floor/iron,
/area/shuttle/vulture)
"MG" = (
/obj/effect/mapping_helpers/smart_pipe/manifold4w/scrubbers/hidden/layer2{
	dir = 6
	},
/obj/effect/mapping_helpers/smart_pipe/manifold4w/supply/hidden/layer4{
	dir = 6
	},
/turf/open/floor/iron,
/area/shuttle/vulture)
"MT" = (
/obj/machinery/mining_laser{
	dir = 1
	},
/turf/closed/wall/mineral/titanium,
/area/shuttle/vulture)
"Ni" = (
/obj/effect/decal/cleanable/dirt,
/turf/open/floor/iron,
/area/shuttle/vulture)
"ND" = (
/obj/machinery/firealarm/directional/west,
/obj/machinery/light/small/directional/west,
/obj/machinery/atmospherics/components/unary/vent_pump/on/layer4,
/turf/open/floor/pod,
/area/shuttle/vulture/helm)
"OE" = (
/obj/effect/decal/cleanable/dirt,
/obj/machinery/light_switch/directional/south,
/obj/effect/mapping_helpers/smart_pipe/manifold4w/scrubbers/hidden/layer2{
	dir = 6
	},
/obj/effect/mapping_helpers/smart_pipe/manifold4w/supply/hidden/layer4{
	dir = 6
	},
/obj/structure/cable,
/turf/open/floor/pod,
/area/shuttle/vulture/helm)
"Pa" = (
/obj/item/storage/toolbox/mechanical,
/obj/effect/decal/cleanable/dirt,
/obj/machinery/door/firedoor,
/obj/effect/turf_decal/stripes/line,
/obj/effect/mapping_helpers/smart_pipe/manifold4w/scrubbers/hidden/layer2{
	dir = 6
	},
/obj/structure/lattice/catwalk/plated,
/turf/open/floor/plating,
/area/shuttle/vulture)
"PI" = (
/obj/structure/closet/firecloset/full,
/turf/open/floor/iron,
/area/shuttle/vulture)
"Qq" = (
/turf/closed/wall/mineral/titanium,
/area/shuttle/vulture/dorm)
"Qv" = (
/obj/structure/chair/stool/bar{
	dir = 8
	},
/obj/effect/mapping_helpers/smart_pipe/manifold4w/scrubbers/hidden/layer2{
	dir = 6
	},
/obj/effect/mapping_helpers/smart_pipe/manifold4w/supply/hidden/layer4{
	dir = 6
	},
/turf/open/floor/iron,
/area/shuttle/vulture)
"QF" = (
/obj/structure/rack,
/obj/item/pickaxe,
/obj/item/storage/toolbox/emergency,
/obj/structure/lattice/catwalk/plated,
/obj/machinery/atmospherics/components/unary/vent_scrubber/on/layer2{
	dir = 1
	},
/turf/open/floor/plating,
/area/shuttle/vulture)
"Tt" = (
/obj/effect/decal/cleanable/dirt,
/obj/machinery/light_switch/directional/north,
/obj/effect/mapping_helpers/smart_pipe/manifold4w/supply/hidden/layer4{
	dir = 6
	},
/obj/effect/mapping_helpers/smart_pipe/manifold4w/scrubbers/hidden/layer2{
	dir = 6
	},
/turf/open/floor/iron,
/area/shuttle/vulture)
"Ul" = (
/turf/closed/wall/mineral/titanium,
/area/shuttle/vulture)
"Vg" = (
/obj/machinery/door/firedoor,
/obj/effect/mapping_helpers/smart_pipe/manifold4w/scrubbers/hidden/layer2{
	dir = 6
	},
/obj/effect/mapping_helpers/smart_pipe/manifold4w/supply/hidden/layer4{
	dir = 6
	},
/obj/structure/cable,
/obj/machinery/door/airlock/glass,
/turf/open/floor/pod,
/area/shuttle/vulture/helm)
"Vu" = (
/obj/structure/closet/crate,
/obj/effect/turf_decal/bot,
/obj/effect/spawner/lootdrop/maintenance/seven,
/obj/effect/decal/cleanable/dirt,
/turf/open/floor/iron,
/area/shuttle/vulture)
"VX" = (
/obj/effect/decal/cleanable/dirt,
/obj/machinery/shower{
	dir = 8
	},
/obj/machinery/atmospherics/components/unary/vent_pump/on/layer4{
	dir = 8
	},
/turf/open/floor/iron/freezer,
/area/shuttle/vulture)
"Wx" = (
/obj/machinery/door/airlock,
/obj/effect/decal/cleanable/dirt,
/obj/machinery/door/firedoor,
/obj/effect/mapping_helpers/smart_pipe/manifold4w/scrubbers/hidden/layer2{
	dir = 6
	},
/obj/effect/mapping_helpers/smart_pipe/manifold4w/supply/hidden/layer4{
	dir = 6
	},
/obj/structure/cable,
/turf/open/floor/pod,
/area/shuttle/vulture/dorm)
"WF" = (
/obj/effect/spawner/structure/window/shuttle,
/obj/machinery/door/poddoor/shutters/preopen{
	id = "vulture_shutter"
	},
/turf/open/floor/plating,
/area/shuttle/vulture/helm)
"XG" = (
/obj/effect/spawner/lootdrop/maintenance,
/obj/effect/mapping_helpers/smart_pipe/manifold4w/scrubbers/hidden/layer2{
	dir = 6
	},
/obj/effect/mapping_helpers/smart_pipe/manifold4w/supply/hidden/layer4{
	dir = 6
	},
/turf/open/floor/iron,
/area/shuttle/vulture)
"XY" = (
/obj/effect/decal/cleanable/dirt,
/obj/structure/table,
/obj/machinery/button/door{
	id = "vulture_shutter";
	name = "safety shutters button"
	},
/obj/item/radio/intercom/wideband/directional/west,
/turf/open/floor/pod,
/area/shuttle/vulture/helm)
"Yt" = (
/obj/item/storage/toolbox/emergency,
/obj/effect/decal/cleanable/dirt,
/obj/machinery/airalarm/directional/east,
/obj/structure/table,
/obj/machinery/light/small/directional/east,
/obj/machinery/atmospherics/components/unary/vent_scrubber/on/layer2,
/turf/open/floor/pod,
/area/shuttle/vulture/helm)

(1,1,1) = {"
Ll
Ll
Qq
Qq
iS
Qq
Qq
mg
Ul
Ul
Ls
Ls
Ls
Ul
Ul
"}
(2,1,1) = {"
MT
Ul
Qq
er
bR
lK
Qq
zR
QF
Ul
Bl
fT
aa
Vu
Ul
"}
(3,1,1) = {"
Ll
Ll
Qq
KO
nF
sr
Qq
hY
Ul
Ul
Cu
aL
Gu
FD
Ul
"}
(4,1,1) = {"
Ll
WF
Qq
Qq
Wx
Qq
Qq
Tt
Ld
nJ
Ni
nz
iu
Ul
Ul
"}
(5,1,1) = {"
Ll
WF
XY
ND
OE
nC
PI
pG
Ni
Ni
Ni
ze
fK
xG
jB
"}
(6,1,1) = {"
Ll
WF
vS
AU
eN
Vg
fG
rI
MG
MG
MG
oz
de
xG
jB
"}
(7,1,1) = {"
Ll
WF
mA
Yt
ac
nC
ar
LP
mB
ff
el
ES
hl
xG
jB
"}
(8,1,1) = {"
Ll
WF
nC
nC
nC
nC
Ul
ee
Qv
wA
GS
Ul
Ul
Ul
Ul
"}
(9,1,1) = {"
Ll
Ll
Ul
do
ry
Jw
Pa
tS
MG
XG
oz
so
pE
JK
Ul
"}
(10,1,1) = {"
MT
Ul
Ul
rk
am
gl
dE
HJ
fq
vF
CN
Ul
hr
VX
Ul
"}
(11,1,1) = {"
Ll
Ll
Ul
Ul
Ul
Ul
Ul
Ul
Ul
Ls
Ul
Ul
Ul
Ul
Ul
"}
