//MAP CONVERTED BY dmm2tgm.py THIS HEADER COMMENT PREVENTS RECONVERSION, DO NOT REMOVE
"a" = (
/turf/closed/wall/mineral/titanium,
/area/shuttle/escape)
"b" = (
/obj/effect/spawner/structure/window/shuttle,
/turf/open/floor/plating,
/area/shuttle/escape)
"c" = (
/obj/effect/turf_decal/tile/brown{
	dir = 1
	},
/obj/effect/turf_decal/tile/brown,
/obj/effect/turf_decal/stripes/line,
/obj/effect/turf_decal/stripes/corner{
	dir = 4
	},
/obj/effect/turf_decal/stripes/corner{
	dir = 1
	},
/turf/open/floor/mineral/titanium/yellow,
/area/shuttle/escape)
"d" = (
/obj/structure/table/reinforced,
/obj/item/storage/firstaid/regular,
/obj/item/book/manual/random,
/obj/structure/extinguisher_cabinet/directional/west,
/obj/effect/turf_decal/tile/neutral{
	dir = 1
	},
/obj/effect/turf_decal/tile/neutral,
/turf/open/floor/mineral/plastitanium,
/area/shuttle/escape)
"e" = (
/obj/structure/chair/comfy/shuttle{
	dir = 1
	},
/obj/effect/turf_decal/tile/neutral{
	dir = 1
	},
/obj/effect/turf_decal/tile/neutral,
/turf/open/floor/mineral/plastitanium,
/area/shuttle/escape)
"g" = (
/obj/structure/chair/comfy/shuttle{
	dir = 4
	},
/obj/effect/turf_decal/tile/neutral{
	dir = 1
	},
/obj/effect/turf_decal/tile/neutral,
/turf/open/floor/mineral/plastitanium,
/area/shuttle/escape)
"h" = (
/obj/effect/turf_decal/stripes/line{
	dir = 9
	},
/obj/effect/turf_decal/tile/brown{
	dir = 1
	},
/obj/effect/turf_decal/tile/brown,
/turf/open/floor/mineral/plastitanium,
/area/shuttle/escape)
"i" = (
/obj/machinery/light/floor,
/obj/effect/turf_decal/stripes/line{
	dir = 1
	},
/obj/effect/turf_decal/tile/brown{
	dir = 1
	},
/obj/effect/turf_decal/tile/brown,
/turf/open/floor/mineral/plastitanium,
/area/shuttle/escape)
"j" = (
/obj/machinery/status_display/evac,
/turf/closed/wall/mineral/titanium,
/area/shuttle/escape)
"k" = (
/obj/machinery/computer/emergency_shuttle,
/obj/effect/turf_decal/tile/neutral{
	dir = 1
	},
/obj/effect/turf_decal/tile/neutral,
/turf/open/floor/mineral/plastitanium,
/area/shuttle/escape)
"l" = (
/obj/machinery/door/window/northright{
	name = "Ferry Cockpit";
	req_access_txt = "19";
	dir = 2
	},
/obj/effect/turf_decal/stripes/line{
	dir = 8
	},
/obj/effect/turf_decal/tile/brown{
	dir = 1
	},
/obj/effect/turf_decal/tile/brown,
/obj/effect/turf_decal/stripes/corner,
/turf/open/floor/mineral/plastitanium,
/area/shuttle/escape)
"m" = (
/obj/structure/chair/comfy/shuttle{
	dir = 1
	},
/obj/effect/turf_decal/tile/blue{
	dir = 1
	},
/obj/effect/turf_decal/tile/blue,
/obj/structure/window/reinforced,
/obj/machinery/light/directional/south,
/turf/open/floor/mineral/plastitanium,
/area/shuttle/escape)
"n" = (
/obj/effect/turf_decal/tile/brown{
	dir = 1
	},
/obj/effect/turf_decal/tile/brown,
/obj/effect/turf_decal/stripes/corner,
/obj/effect/turf_decal/stripes/corner{
	dir = 4
	},
/obj/effect/turf_decal/stripes/corner{
	dir = 1
	},
/obj/effect/turf_decal/stripes/corner{
	dir = 8
	},
/turf/open/floor/mineral/titanium/yellow,
/area/shuttle/escape)
"o" = (
/obj/effect/turf_decal/tile/brown{
	dir = 1
	},
/obj/effect/turf_decal/tile/brown,
/obj/effect/turf_decal/stripes/line,
/obj/effect/turf_decal/stripes/line{
	dir = 1
	},
/turf/open/floor/mineral/titanium/yellow,
/area/shuttle/escape)
"p" = (
/obj/effect/turf_decal/tile/brown{
	dir = 1
	},
/obj/effect/turf_decal/tile/brown,
/obj/effect/turf_decal/stripes/end{
	dir = 4
	},
/obj/structure/extinguisher_cabinet/directional/east,
/turf/open/floor/mineral/titanium/yellow,
/area/shuttle/escape)
"q" = (
/obj/structure/table,
/obj/item/storage/firstaid/fire{
	pixel_x = 4;
	pixel_y = 4
	},
/obj/item/storage/firstaid/regular{
	pixel_x = 2;
	pixel_y = 2
	},
/obj/item/storage/firstaid/regular,
/obj/structure/window/reinforced,
/obj/effect/turf_decal/tile/blue{
	dir = 1
	},
/obj/effect/turf_decal/tile/blue,
/obj/machinery/vending/wallmed/directional/east,
/turf/open/floor/mineral/plastitanium,
/area/shuttle/escape)
"r" = (
/obj/structure/chair/comfy/shuttle{
	dir = 1
	},
/obj/structure/window/reinforced,
/turf/open/floor/mineral/plastitanium,
/area/shuttle/escape)
"s" = (
/obj/effect/turf_decal/tile/blue,
/obj/effect/turf_decal/tile/blue{
	dir = 1
	},
/obj/effect/turf_decal/stripes/line,
/obj/effect/turf_decal/stripes/corner{
	dir = 4
	},
/obj/effect/turf_decal/stripes/corner{
	dir = 1
	},
/turf/open/floor/mineral/titanium/white,
/area/shuttle/escape)
"t" = (
/obj/structure/window/reinforced{
	dir = 1
	},
/obj/structure/shuttle/engine/heater,
/turf/open/floor/plating/airless,
/area/shuttle/escape)
"u" = (
/obj/structure/shuttle/engine/propulsion,
/turf/open/floor/plating/airless,
/area/shuttle/escape)
"v" = (
/obj/structure/window/reinforced,
/obj/structure/chair/comfy/shuttle{
	dir = 1
	},
/obj/effect/turf_decal/tile/brown{
	dir = 1
	},
/obj/effect/turf_decal/tile/brown,
/obj/effect/turf_decal/stripes/line,
/turf/open/floor/mineral/plastitanium,
/area/shuttle/escape)
"w" = (
/obj/effect/turf_decal/tile/blue{
	dir = 1
	},
/obj/effect/turf_decal/tile/blue,
/obj/effect/turf_decal/stripes/line,
/obj/effect/turf_decal/stripes/line{
	dir = 1
	},
/turf/open/floor/mineral/titanium/white,
/area/shuttle/escape)
"x" = (
/obj/machinery/door/window/eastleft{
	dir = 8;
	name = "Ferry First Aid";
	req_access_txt = "5"
	},
/obj/effect/turf_decal/tile/blue{
	dir = 1
	},
/obj/effect/turf_decal/tile/blue,
/obj/effect/turf_decal/stripes/line,
/obj/effect/turf_decal/stripes/line{
	dir = 1
	},
/turf/open/floor/mineral/titanium/white,
/area/shuttle/escape)
"y" = (
/obj/structure/window/reinforced,
/obj/effect/turf_decal/tile/blue{
	dir = 1
	},
/obj/effect/turf_decal/tile/blue,
/obj/effect/turf_decal/stripes/end,
/turf/open/floor/mineral/titanium/white,
/area/shuttle/escape)
"z" = (
/obj/effect/turf_decal/tile/brown{
	dir = 1
	},
/obj/effect/turf_decal/tile/brown,
/obj/structure/extinguisher_cabinet/directional/east,
/obj/effect/turf_decal/stripes/end{
	dir = 4
	},
/turf/open/floor/mineral/titanium/yellow,
/area/shuttle/escape)
"A" = (
/obj/structure/window/reinforced,
/obj/structure/chair/comfy/shuttle{
	dir = 1
	},
/obj/structure/window/reinforced{
	dir = 8
	},
/turf/open/floor/mineral/plastitanium,
/area/shuttle/escape)
"B" = (
/obj/effect/turf_decal/tile/blue{
	dir = 1
	},
/obj/effect/turf_decal/tile/blue,
/obj/effect/turf_decal/stripes/line{
	dir = 5
	},
/obj/effect/turf_decal/stripes/corner{
	dir = 8
	},
/turf/open/floor/mineral/titanium/white,
/area/shuttle/escape)
"C" = (
/obj/effect/turf_decal/tile/brown{
	dir = 1
	},
/obj/effect/turf_decal/tile/brown,
/obj/machinery/light/floor,
/obj/effect/turf_decal/stripes/line,
/obj/effect/turf_decal/stripes/line{
	dir = 1
	},
/turf/open/floor/mineral/titanium/yellow,
/area/shuttle/escape)
"D" = (
/obj/structure/extinguisher_cabinet/directional/east,
/turf/open/floor/mineral/plastitanium,
/area/shuttle/escape)
"E" = (
/obj/structure/window/reinforced,
/obj/structure/chair/comfy/shuttle{
	dir = 8
	},
/obj/effect/turf_decal/tile/neutral{
	dir = 1
	},
/obj/effect/turf_decal/tile/neutral,
/turf/open/floor/mineral/plastitanium,
/area/shuttle/escape)
"F" = (
/obj/effect/turf_decal/stripes/line{
	dir = 5
	},
/obj/effect/turf_decal/tile/brown{
	dir = 1
	},
/obj/effect/turf_decal/tile/brown,
/turf/open/floor/mineral/plastitanium,
/area/shuttle/escape)
"G" = (
/obj/structure/window/reinforced,
/obj/structure/chair/comfy/shuttle{
	dir = 1
	},
/turf/open/floor/mineral/plastitanium,
/area/shuttle/escape)
"H" = (
/obj/docking_port/mobile/emergency{
	dwidth = 3;
	height = 15;
	name = "Skyline Emergency Shuttle";
	width = 7
	},
/obj/machinery/door/airlock/titanium{
	name = "Emergency Shuttle Airlock"
	},
/obj/structure/fans/tiny,
/obj/effect/turf_decal/tile/brown{
	dir = 1
	},
/obj/effect/turf_decal/tile/brown,
/obj/effect/turf_decal/stripes/line{
	dir = 4
	},
/obj/effect/turf_decal/stripes/line{
	dir = 8
	},
/turf/open/floor/mineral/plastitanium,
/area/shuttle/escape)
"I" = (
/turf/closed/wall/mineral/plastitanium/nodiagonal,
/area/shuttle/escape)
"J" = (
/obj/effect/turf_decal/tile/brown{
	dir = 1
	},
/obj/effect/turf_decal/tile/brown,
/obj/effect/turf_decal/stripes/end{
	dir = 4
	},
/turf/open/floor/mineral/titanium/yellow,
/area/shuttle/escape)
"K" = (
/turf/template_noop,
/area/space)
"L" = (
/obj/structure/chair/comfy/shuttle{
	dir = 8
	},
/obj/effect/turf_decal/tile/neutral{
	dir = 1
	},
/obj/effect/turf_decal/tile/neutral,
/turf/open/floor/mineral/plastitanium,
/area/shuttle/escape)
"M" = (
/obj/machinery/computer/communications,
/obj/effect/turf_decal/tile/neutral{
	dir = 1
	},
/obj/effect/turf_decal/tile/neutral,
/turf/open/floor/mineral/plastitanium,
/area/shuttle/escape)
"N" = (
/obj/machinery/door/airlock/titanium{
	name = "Emergency Shuttle Airlock"
	},
/obj/structure/fans/tiny,
/obj/effect/turf_decal/stripes/line{
	dir = 4
	},
/obj/effect/turf_decal/stripes/line{
	dir = 8
	},
/turf/open/floor/mineral/plastitanium,
/area/shuttle/escape)
"O" = (
/obj/effect/turf_decal/tile/brown{
	dir = 1
	},
/obj/effect/turf_decal/tile/brown,
/obj/machinery/vending/wallmed/directional/west,
/obj/effect/turf_decal/stripes/corner,
/obj/effect/turf_decal/stripes/corner{
	dir = 4
	},
/obj/effect/turf_decal/stripes/line{
	dir = 8
	},
/obj/effect/turf_decal/stripes/white/line,
/turf/open/floor/mineral/titanium/yellow,
/area/shuttle/escape)
"P" = (
/obj/effect/turf_decal/tile/blue,
/obj/effect/turf_decal/tile/blue{
	dir = 1
	},
/obj/effect/turf_decal/stripes/line{
	dir = 4
	},
/obj/effect/turf_decal/stripes/line{
	dir = 8
	},
/obj/effect/turf_decal/stripes/white/line{
	dir = 1
	},
/turf/open/floor/mineral/titanium/white,
/area/shuttle/escape)
"Q" = (
/obj/structure/closet/crate/medical,
/obj/item/storage/firstaid/regular,
/obj/item/storage/firstaid/o2{
	pixel_x = 3;
	pixel_y = 3
	},
/obj/item/storage/firstaid/toxin{
	pixel_x = -4;
	pixel_y = 3
	},
/obj/item/healthanalyzer{
	pixel_x = 3;
	pixel_y = 3
	},
/obj/item/lazarus_injector,
/obj/effect/turf_decal/bot,
/mob/living/simple_animal/bot/medbot{
	name = "\improper emergency medibot";
	pixel_x = -3;
	pixel_y = 2
	},
/obj/structure/window/reinforced,
/obj/effect/turf_decal/tile/blue,
/obj/effect/turf_decal/tile/blue{
	dir = 1
	},
/turf/open/floor/mineral/plastitanium,
/area/shuttle/escape)
"R" = (
/obj/machinery/stasis,
/obj/effect/turf_decal/tile/blue{
	dir = 1
	},
/obj/effect/turf_decal/tile/blue,
/obj/structure/extinguisher_cabinet/directional/east,
/turf/open/floor/mineral/plastitanium,
/area/shuttle/escape)
"S" = (
/obj/structure/window/reinforced,
/obj/structure/chair/comfy/shuttle{
	dir = 4
	},
/obj/effect/turf_decal/tile/neutral{
	dir = 1
	},
/obj/effect/turf_decal/tile/neutral,
/turf/open/floor/mineral/plastitanium,
/area/shuttle/escape)
"T" = (
/obj/structure/window/reinforced,
/obj/structure/window/reinforced{
	dir = 8
	},
/obj/structure/chair/comfy/shuttle{
	dir = 1
	},
/obj/effect/turf_decal/tile/blue{
	dir = 1
	},
/obj/effect/turf_decal/tile/blue,
/turf/open/floor/mineral/plastitanium,
/area/shuttle/escape)
"U" = (
/obj/structure/chair/comfy/shuttle{
	dir = 1
	},
/obj/structure/window/reinforced,
/obj/structure/window/reinforced{
	dir = 8
	},
/turf/open/floor/mineral/plastitanium,
/area/shuttle/escape)
"V" = (
/obj/machinery/computer/crew,
/obj/effect/turf_decal/tile/neutral{
	dir = 1
	},
/obj/effect/turf_decal/tile/neutral,
/turf/open/floor/mineral/plastitanium,
/area/shuttle/escape)
"W" = (
/obj/effect/turf_decal/tile/brown{
	dir = 1
	},
/obj/effect/turf_decal/tile/brown,
/obj/effect/turf_decal/stripes/line{
	dir = 9
	},
/obj/machinery/vending/wallmed/directional/west,
/obj/effect/turf_decal/stripes/corner,
/turf/open/floor/mineral/titanium/yellow,
/area/shuttle/escape)
"X" = (
/obj/effect/turf_decal/tile/brown{
	dir = 1
	},
/obj/effect/turf_decal/tile/brown,
/obj/effect/turf_decal/stripes/line{
	dir = 4
	},
/obj/effect/turf_decal/stripes/line{
	dir = 8
	},
/turf/open/floor/mineral/titanium/yellow,
/area/shuttle/escape)
"Y" = (
/obj/machinery/door/window/northright{
	name = "Ferry Cockpit";
	req_access_txt = "19";
	dir = 2
	},
/obj/effect/turf_decal/stripes/line{
	dir = 4
	},
/obj/effect/turf_decal/tile/brown{
	dir = 1
	},
/obj/effect/turf_decal/tile/brown,
/obj/effect/turf_decal/stripes/corner{
	dir = 8
	},
/turf/open/floor/mineral/plastitanium,
/area/shuttle/escape)
"Z" = (
/obj/structure/table/reinforced,
/obj/item/gps{
	gpstag = "STV5"
	},
/obj/effect/turf_decal/tile/neutral{
	dir = 1
	},
/obj/effect/turf_decal/tile/neutral,
/turf/open/floor/mineral/plastitanium,
/area/shuttle/escape)

(1,1,1) = {"
K
a
a
a
a
a
b
H
b
a
b
N
I
I
K
"}
(2,1,1) = {"
b
a
d
g
S
W
X
n
X
O
P
s
Q
t
u
"}
(3,1,1) = {"
b
M
e
h
l
c
A
o
U
o
U
x
T
t
u
"}
(4,1,1) = {"
b
k
e
i
v
o
G
C
r
o
r
w
m
I
I
"}
(5,1,1) = {"
b
V
e
F
Y
c
G
J
r
o
r
B
y
t
u
"}
(6,1,1) = {"
b
a
Z
L
E
z
G
D
r
p
r
R
q
t
u
"}
(7,1,1) = {"
K
a
j
a
a
a
b
a
b
a
a
a
I
I
K
"}
