//MAP CONVERTED BY dmm2tgm.py THIS HEADER COMMENT PREVENTS RECONVERSION, DO NOT REMOVE
"bw" = (
/obj/effect/decal/cleanable/dirt,
/obj/machinery/atmospherics/components/unary/vent_pump/on/layer4{
	dir = 1
	},
/obj/item/storage/toolbox/mechanical{
	pixel_y = 4
	},
/obj/structure/lattice/catwalk/plated/dark,
/turf/open/floor/plating,
/area/shuttle/crow/engineering)
"bZ" = (
/obj/machinery/atmospherics/components/unary/portables_connector/visible{
	dir = 4
	},
/obj/machinery/portable_atmospherics/canister/carbon_dioxide,
/obj/structure/cable,
/obj/effect/decal/cleanable/dirt,
/obj/structure/lattice/catwalk/plated/dark,
/turf/open/floor/plating,
/area/shuttle/crow/engineering)
"cS" = (
/obj/machinery/power/terminal{
	dir = 8
	},
/obj/structure/cable,
/obj/effect/decal/cleanable/dirt,
/obj/effect/spawner/lootdrop/maintenance,
/obj/structure/lattice/catwalk/plated/dark,
/turf/open/floor/plating,
/area/shuttle/crow/engineering)
"dd" = (
/obj/effect/turf_decal/bot,
/obj/effect/decal/cleanable/dirt,
/obj/effect/spawner/lootdrop/maintenance,
/obj/structure/closet/crate,
/turf/open/floor/iron,
/area/shuttle/crow/cargo)
"dm" = (
/obj/effect/spawner/structure/window/shuttle,
/obj/machinery/door/poddoor/shutters/preopen{
	id = "crow_shutter"
	},
/turf/open/floor/plating,
/area/shuttle/crow/helm)
"eb" = (
/obj/structure/cable,
/obj/machinery/airalarm{
	dir = 1;
	pixel_y = -24
	},
/obj/effect/mapping_helpers/smart_pipe/manifold4w/scrubbers/hidden/layer2{
	dir = 9
	},
/obj/effect/mapping_helpers/smart_pipe/manifold4w/supply/hidden/layer4{
	dir = 1
	},
/obj/effect/mapping_helpers/smart_pipe/manifold4w/orange/hidden,
/turf/open/floor/iron,
/area/shuttle/crow/cargo)
"ec" = (
/obj/structure/cable,
/obj/machinery/door/firedoor,
/obj/machinery/door/airlock/command/glass{
	name = "Crow Helm"
	},
/obj/effect/mapping_helpers/smart_pipe/manifold4w/scrubbers/hidden/layer2{
	dir = 9
	},
/obj/effect/mapping_helpers/smart_pipe/manifold4w/supply/hidden/layer4{
	dir = 1
	},
/turf/open/floor/pod,
/area/shuttle/crow/helm)
"eT" = (
/obj/effect/spawner/structure/window/shuttle,
/obj/machinery/door/poddoor/shutters/preopen{
	id = "crow_shutter"
	},
/turf/open/floor/plating,
/area/shuttle/crow/cargo)
"fw" = (
/obj/structure/closet/excavation,
/turf/open/floor/pod,
/area/shuttle/crow)
"fJ" = (
/obj/effect/decal/cleanable/dirt,
/obj/item/stock_parts/cell/high,
/obj/machinery/light/warm/directional/east,
/obj/structure/lattice/catwalk/plated/dark,
/obj/machinery/atmospherics/components/binary/passive_gate/layer4{
	dir = 1;
	name = "air supply gate"
	},
/turf/open/floor/plating,
/area/shuttle/crow/engineering)
"fM" = (
/turf/open/floor/iron,
/area/shuttle/crow/cargo)
"gn" = (
/obj/machinery/atmospherics/components/unary/engine{
	dir = 8
	},
/turf/closed/wall/mineral/titanium,
/area/shuttle/crow/cargo)
"gD" = (
/obj/effect/decal/cleanable/dirt,
/obj/machinery/light_switch/directional/east,
/obj/effect/turf_decal/bot,
/turf/open/floor/iron,
/area/shuttle/crow/cargo)
"gX" = (
/obj/effect/decal/cleanable/dirt,
/obj/effect/decal/cleanable/oil,
/turf/open/floor/iron,
/area/shuttle/crow/cargo)
"hk" = (
/obj/structure/fans/tiny,
/obj/machinery/door/poddoor/shutters{
	id = "crow_cargo"
	},
/turf/open/floor/plating,
/area/shuttle/crow/cargo)
"hn" = (
/obj/structure/rack,
/obj/item/storage/bag/ore,
/obj/item/pickaxe,
/obj/item/flashlight,
/obj/item/mining_scanner,
/obj/item/pickaxe,
/obj/item/mining_scanner,
/obj/item/flashlight,
/obj/item/storage/bag/ore,
/obj/item/pickaxe,
/obj/item/gun/energy/kinetic_accelerator,
/turf/open/floor/pod,
/area/shuttle/crow)
"hB" = (
/obj/structure/cable,
/obj/machinery/power/apc/auto_name/south{
	locked = 0
	},
/obj/effect/decal/cleanable/dirt,
/obj/effect/mapping_helpers/smart_pipe/manifold4w/scrubbers/hidden/layer2{
	dir = 9
	},
/obj/effect/mapping_helpers/smart_pipe/manifold4w/supply/hidden/layer4{
	dir = 1
	},
/obj/effect/mapping_helpers/smart_pipe/manifold4w/orange/hidden,
/turf/open/floor/iron,
/area/shuttle/crow/cargo)
"hD" = (
/obj/effect/decal/cleanable/dirt,
/obj/structure/table,
/obj/machinery/firealarm/directional/west,
/obj/item/storage/toolbox/emergency,
/obj/machinery/light_switch/directional/north,
/obj/machinery/atmospherics/components/unary/vent_pump/on/layer4,
/obj/machinery/light/warm/directional/north,
/turf/open/floor/pod,
/area/shuttle/crow/helm)
"iP" = (
/obj/effect/decal/cleanable/dirt,
/turf/open/floor/iron,
/area/shuttle/crow/cargo)
"iX" = (
/obj/effect/decal/cleanable/dirt,
/obj/effect/mapping_helpers/smart_pipe/manifold4w/supply/hidden/layer4{
	dir = 1
	},
/obj/structure/rack,
/obj/item/storage/box/lights/tubes,
/obj/item/flashlight{
	pixel_x = 3;
	pixel_y = 3
	},
/obj/structure/lattice/catwalk/plated/dark,
/turf/open/floor/plating,
/area/shuttle/crow/engineering)
"jh" = (
/obj/effect/spawner/structure/window/shuttle,
/obj/machinery/door/poddoor/shutters/preopen{
	id = "crow_shutter"
	},
/turf/open/floor/plating,
/area/shuttle/crow)
"jH" = (
/obj/effect/spawner/lootdrop/maintenance,
/turf/open/floor/iron,
/area/shuttle/crow/cargo)
"jL" = (
/turf/template_noop,
/area/template_noop)
"kN" = (
/obj/machinery/portable_atmospherics/canister,
/obj/effect/decal/cleanable/dirt,
/obj/machinery/atmospherics/components/unary/portables_connector/visible/layer2{
	dir = 1
	},
/obj/structure/lattice/catwalk/plated/dark,
/turf/open/floor/plating,
/area/shuttle/crow/engineering)
"lI" = (
/obj/effect/spawner/structure/window/shuttle,
/turf/open/floor/plating,
/area/shuttle/crow/helm)
"lR" = (
/obj/effect/turf_decal/bot,
/obj/effect/decal/cleanable/dirt,
/obj/structure/closet/crate,
/obj/item/reagent_containers/food/drinks/bottle/wine,
/obj/item/reagent_containers/food/drinks/drinkingglass,
/obj/item/reagent_containers/food/drinks/drinkingglass,
/turf/open/floor/iron,
/area/shuttle/crow/cargo)
"mR" = (
/obj/effect/decal/cleanable/dirt,
/obj/machinery/atmospherics/components/unary/vent_scrubber/on/layer2{
	dir = 8
	},
/turf/open/floor/pod,
/area/shuttle/crow)
"ne" = (
/obj/structure/cable,
/obj/machinery/door/firedoor,
/obj/effect/mapping_helpers/smart_pipe/manifold4w/scrubbers/hidden/layer2{
	dir = 9
	},
/obj/effect/mapping_helpers/smart_pipe/manifold4w/supply/hidden/layer4{
	dir = 1
	},
/obj/machinery/door/airlock/glass,
/obj/effect/mapping_helpers/smart_pipe/manifold4w/orange/hidden,
/turf/open/floor/iron,
/area/shuttle/crow/cargo)
"np" = (
/obj/effect/decal/cleanable/dirt,
/obj/structure/table,
/obj/item/storage/toolbox/emergency,
/obj/item/gps/mining,
/turf/open/floor/pod,
/area/shuttle/crow)
"nK" = (
/obj/machinery/atmospherics/components/unary/vent_pump/on/layer4,
/obj/structure/lattice/catwalk/plated/dark,
/obj/effect/turf_decal/stripes/line{
	dir = 1
	},
/turf/open/floor/plating,
/area/shuttle/crow)
"og" = (
/obj/machinery/airalarm{
	dir = 4;
	pixel_x = -24
	},
/obj/effect/decal/cleanable/dirt,
/obj/effect/mapping_helpers/smart_pipe/manifold4w/supply/hidden/layer4{
	dir = 1
	},
/turf/open/floor/pod,
/area/shuttle/crow/helm)
"oH" = (
/obj/structure/cable,
/obj/effect/decal/cleanable/dirt,
/obj/effect/mapping_helpers/smart_pipe/manifold4w/supply/hidden/layer4{
	dir = 1
	},
/obj/machinery/door/airlock/engineering{
	name = "Crow Engineering"
	},
/obj/effect/mapping_helpers/smart_pipe/manifold4w/scrubbers/hidden/layer2{
	dir = 9
	},
/obj/structure/lattice/catwalk/plated/dark,
/obj/effect/mapping_helpers/smart_pipe/manifold4w/orange/hidden,
/turf/open/floor/plating,
/area/shuttle/crow/engineering)
"pL" = (
/obj/machinery/computer/shuttle/exploration_crow{
	dir = 8
	},
/turf/open/floor/pod,
/area/shuttle/crow/helm)
"qb" = (
/obj/effect/decal/cleanable/dirt,
/obj/machinery/atmospherics/components/unary/vent_pump/on/layer4{
	dir = 4
	},
/obj/effect/mapping_helpers/smart_pipe/manifold4w/orange/hidden,
/turf/open/floor/iron,
/area/shuttle/crow/cargo)
"qM" = (
/obj/machinery/power/smes/engineering{
	charge = 1e+006
	},
/obj/structure/cable,
/obj/effect/decal/cleanable/dirt,
/obj/structure/lattice/catwalk/plated/dark,
/obj/structure/sign/warning/electricshock{
	pixel_x = -32
	},
/turf/open/floor/plating,
/area/shuttle/crow/engineering)
"sB" = (
/obj/effect/decal/cleanable/dirt,
/obj/effect/mapping_helpers/smart_pipe/manifold4w/orange/hidden,
/turf/open/floor/iron,
/area/shuttle/crow/cargo)
"tN" = (
/obj/structure/table,
/obj/machinery/recharger,
/obj/item/storage/firstaid/regular{
	pixel_x = 1;
	pixel_y = -20
	},
/obj/machinery/light/warm/directional/east,
/obj/structure/extinguisher_cabinet/directional/east,
/turf/open/floor/pod,
/area/shuttle/crow)
"um" = (
/obj/effect/decal/cleanable/dirt,
/obj/structure/closet/excavation,
/obj/machinery/light/warm/directional/south,
/turf/open/floor/pod,
/area/shuttle/crow)
"uo" = (
/obj/structure/table,
/obj/item/storage/firstaid/brute{
	pixel_x = 3;
	pixel_y = 3
	},
/obj/item/storage/firstaid/fire,
/obj/item/storage/firstaid/toxin{
	pixel_x = -3;
	pixel_y = -3
	},
/turf/open/floor/pod,
/area/shuttle/crow)
"uQ" = (
/obj/effect/decal/cleanable/dirt,
/obj/machinery/atmospherics/components/unary/vent_pump/on/layer4,
/turf/open/floor/iron,
/area/shuttle/crow)
"uY" = (
/obj/effect/turf_decal/bot,
/obj/effect/decal/cleanable/dirt,
/obj/structure/extinguisher_cabinet{
	pixel_x = 27
	},
/obj/machinery/light/warm/directional/north,
/obj/structure/sign/warning/movingparts/small{
	pixel_y = 32
	},
/turf/open/floor/iron,
/area/shuttle/crow/cargo)
"vj" = (
/obj/structure/cable,
/obj/machinery/power/apc/auto_name/west{
	locked = 0
	},
/obj/effect/decal/cleanable/dirt,
/obj/effect/mapping_helpers/smart_pipe/manifold4w/scrubbers/hidden/layer2{
	dir = 9
	},
/obj/effect/mapping_helpers/smart_pipe/manifold4w/supply/hidden/layer4{
	dir = 1
	},
/turf/open/floor/pod,
/area/shuttle/crow/helm)
"wt" = (
/obj/effect/decal/cleanable/dirt,
/obj/machinery/light/warm/directional/west,
/obj/effect/mapping_helpers/smart_pipe/manifold4w/orange/hidden,
/turf/open/floor/iron,
/area/shuttle/crow/cargo)
"wM" = (
/obj/structure/shuttle/engine/heater{
	dir = 8
	},
/obj/structure/window/reinforced{
	dir = 4
	},
/obj/effect/mapping_helpers/smart_pipe/manifold4w/orange/visible,
/turf/open/floor/plating,
/area/shuttle/crow/cargo)
"zn" = (
/obj/structure/cable,
/obj/effect/decal/cleanable/dirt,
/obj/effect/decal/cleanable/oil,
/obj/effect/mapping_helpers/smart_pipe/manifold4w/scrubbers/hidden/layer2{
	dir = 9
	},
/obj/effect/mapping_helpers/smart_pipe/manifold4w/supply/hidden/layer4{
	dir = 1
	},
/obj/machinery/meter/atmos/layer2,
/obj/machinery/meter/atmos/layer4,
/obj/structure/lattice/catwalk/plated/dark,
/obj/effect/mapping_helpers/smart_pipe/manifold4w/orange/hidden,
/turf/open/floor/plating,
/area/shuttle/crow/engineering)
"zS" = (
/obj/effect/decal/cleanable/dirt,
/obj/machinery/atmospherics/components/unary/vent_scrubber/on/layer2,
/obj/machinery/light_switch/directional/north,
/turf/open/floor/iron,
/area/shuttle/crow)
"AB" = (
/obj/effect/decal/cleanable/dirt,
/obj/machinery/modular_computer/console/preset/civilian{
	dir = 8
	},
/obj/item/radio/intercom/wideband/directional/south,
/turf/open/floor/pod,
/area/shuttle/crow/helm)
"AN" = (
/obj/effect/decal/cleanable/dirt,
/obj/machinery/atmospherics/components/binary/pump/layer2,
/obj/structure/lattice/catwalk/plated/dark,
/turf/open/floor/plating,
/area/shuttle/crow/engineering)
"AU" = (
/obj/machinery/door/airlock/external/glass,
/obj/machinery/door/firedoor,
/obj/structure/lattice/catwalk/plated/dark,
/obj/effect/mapping_helpers/smart_pipe/manifold4w/supply/hidden/layer4{
	dir = 1
	},
/turf/open/floor/plating,
/area/shuttle/crow)
"Bt" = (
/obj/structure/cable,
/obj/machinery/power/apc/auto_name/west{
	locked = 0
	},
/obj/effect/decal/cleanable/dirt,
/obj/structure/chair/comfy/shuttle{
	dir = 4
	},
/obj/effect/mapping_helpers/smart_pipe/manifold4w/supply/hidden/layer4{
	dir = 1
	},
/turf/open/floor/pod,
/area/shuttle/crow)
"Cc" = (
/obj/machinery/door/firedoor,
/obj/machinery/door/airlock/glass,
/turf/open/floor/iron,
/area/shuttle/crow/cargo)
"CG" = (
/obj/structure/lattice/catwalk/plated/dark,
/obj/structure/tank_dispenser/oxygen,
/obj/machinery/light/warm/directional/east,
/turf/open/floor/plating,
/area/shuttle/crow)
"CR" = (
/obj/structure/reagent_dispensers/fueltank,
/obj/effect/turf_decal/bot,
/obj/effect/decal/cleanable/dirt,
/turf/open/floor/iron,
/area/shuttle/crow/cargo)
"Dt" = (
/obj/structure/cable,
/obj/machinery/power/apc/auto_name/north{
	locked = 0
	},
/obj/effect/decal/cleanable/dirt,
/obj/effect/mapping_helpers/smart_pipe/manifold4w/scrubbers/hidden/layer2{
	dir = 9
	},
/obj/machinery/atmospherics/components/binary/pump{
	dir = 4
	},
/obj/structure/lattice/catwalk/plated/dark,
/turf/open/floor/plating,
/area/shuttle/crow/engineering)
"Dy" = (
/obj/effect/turf_decal/bot,
/obj/effect/decal/cleanable/dirt,
/obj/machinery/firealarm/directional/east,
/turf/open/floor/iron,
/area/shuttle/crow/cargo)
"DO" = (
/obj/effect/decal/cleanable/dirt,
/obj/machinery/holopad/long_range,
/turf/open/floor/pod,
/area/shuttle/crow)
"DX" = (
/obj/effect/decal/cleanable/dirt,
/obj/effect/spawner/lootdrop/maintenance,
/obj/machinery/atmospherics/components/unary/vent_scrubber/on/layer2{
	dir = 1
	},
/obj/structure/lattice/catwalk/plated/dark,
/turf/open/floor/plating,
/area/shuttle/crow/engineering)
"Eq" = (
/obj/machinery/door/airlock/external/glass,
/obj/structure/fans/tiny,
/obj/structure/lattice/catwalk/plated/dark,
/turf/open/floor/plating,
/area/shuttle/crow)
"Fg" = (
/obj/machinery/airalarm{
	dir = 4;
	pixel_x = -24
	},
/obj/effect/decal/cleanable/dirt,
/obj/structure/chair/comfy/shuttle{
	dir = 4
	},
/obj/machinery/atmospherics/components/unary/vent_pump/on/layer4{
	dir = 1
	},
/turf/open/floor/pod,
/area/shuttle/crow)
"Fz" = (
/obj/effect/decal/cleanable/dirt,
/obj/effect/mapping_helpers/smart_pipe/manifold4w/supply/hidden/layer4{
	dir = 1
	},
/obj/effect/mapping_helpers/smart_pipe/manifold4w/scrubbers/hidden/layer2{
	dir = 9
	},
/turf/open/floor/iron,
/area/shuttle/crow)
"FP" = (
/obj/structure/cable,
/obj/effect/mapping_helpers/smart_pipe/manifold4w/scrubbers/hidden/layer2{
	dir = 9
	},
/obj/effect/mapping_helpers/smart_pipe/manifold4w/supply/hidden/layer4{
	dir = 1
	},
/obj/structure/sign/departments/engineering{
	pixel_y = -32
	},
/turf/open/floor/iron,
/area/shuttle/crow)
"Gz" = (
/obj/machinery/door/airlock/external/glass,
/obj/structure/fans/tiny,
/obj/docking_port/mobile{
	dir = 2;
	dwidth = 7;
	height = 11;
	id = "crow";
	launch_status = 0;
	name = "ESS Crow";
	overmap_shuttle_type = /datum/overmap_object/shuttle/ess_crow;
	port_direction = 8;
	preferred_direction = 4;
	width = 15
	},
/obj/structure/lattice/catwalk/plated/dark,
/turf/open/floor/plating,
/area/shuttle/crow)
"Hu" = (
/turf/open/floor/pod,
/area/shuttle/crow)
"HK" = (
/obj/effect/decal/cleanable/dirt,
/obj/machinery/atmospherics/components/unary/vent_scrubber/on/layer2,
/turf/open/floor/iron,
/area/shuttle/crow/cargo)
"HV" = (
/obj/structure/cable,
/obj/effect/decal/cleanable/dirt,
/obj/effect/mapping_helpers/smart_pipe/manifold4w/scrubbers/hidden/layer2{
	dir = 9
	},
/obj/effect/mapping_helpers/smart_pipe/manifold4w/supply/hidden/layer4{
	dir = 1
	},
/turf/open/floor/pod,
/area/shuttle/crow)
"Ic" = (
/obj/effect/turf_decal/bot,
/obj/effect/decal/cleanable/dirt,
/obj/effect/mapping_helpers/smart_pipe/manifold4w/orange/hidden,
/obj/effect/spawner/lootdrop/maintenance/five,
/obj/structure/closet/crate,
/turf/open/floor/iron,
/area/shuttle/crow/cargo)
"IN" = (
/obj/effect/decal/cleanable/dirt,
/obj/machinery/atmospherics/components/unary/vent_scrubber/on/layer2{
	dir = 8
	},
/obj/structure/chair/comfy/shuttle{
	dir = 4
	},
/turf/open/floor/pod,
/area/shuttle/crow/helm)
"KC" = (
/obj/structure/cable,
/obj/effect/decal/cleanable/dirt,
/obj/machinery/light_switch/directional/north,
/obj/effect/mapping_helpers/smart_pipe/manifold4w/supply/hidden/layer4{
	dir = 1
	},
/obj/effect/mapping_helpers/smart_pipe/manifold4w/scrubbers/hidden/layer2{
	dir = 9
	},
/obj/structure/lattice/catwalk/plated/dark,
/obj/effect/mapping_helpers/smart_pipe/manifold4w/orange/hidden,
/obj/machinery/recharge_station,
/turf/open/floor/plating,
/area/shuttle/crow/engineering)
"KJ" = (
/obj/effect/decal/cleanable/blood/old,
/turf/open/floor/iron,
/area/shuttle/crow/cargo)
"Lp" = (
/obj/machinery/button/door/directional/west{
	id = "crow_cargo";
	name = "cargo shutters"
	},
/obj/structure/fans/tiny,
/obj/machinery/door/poddoor/shutters{
	id = "crow_cargo"
	},
/turf/open/floor/plating,
/area/shuttle/crow/cargo)
"LG" = (
/obj/effect/mapping_helpers/smart_pipe/manifold4w/orange/hidden,
/turf/closed/wall/mineral/titanium,
/area/shuttle/crow/cargo)
"MH" = (
/obj/effect/decal/cleanable/dirt,
/obj/structure/rack,
/obj/structure/lattice/catwalk/plated/dark,
/obj/item/clothing/mask/breath{
	pixel_x = 4;
	pixel_y = 4
	},
/obj/item/clothing/mask/breath,
/obj/item/clothing/mask/breath,
/turf/open/floor/plating,
/area/shuttle/crow)
"NJ" = (
/obj/structure/cable,
/obj/effect/decal/cleanable/dirt,
/obj/machinery/light/warm/directional/west,
/obj/machinery/portable_atmospherics/canister/oxygen,
/obj/structure/lattice/catwalk/plated/dark,
/turf/open/floor/plating,
/area/shuttle/crow/engineering)
"OI" = (
/turf/closed/wall/mineral/titanium,
/area/shuttle/crow/helm)
"OP" = (
/obj/structure/lattice/catwalk/plated/dark,
/obj/effect/turf_decal/stripes/line{
	dir = 1
	},
/turf/open/floor/plating,
/area/shuttle/crow)
"Pc" = (
/obj/effect/mapping_helpers/smart_pipe/manifold4w/supply/hidden/layer4{
	dir = 1
	},
/obj/structure/lattice/catwalk/plated/dark,
/turf/open/floor/plating,
/area/shuttle/crow)
"PR" = (
/obj/structure/table,
/obj/machinery/button/door{
	id = "crow_shutter";
	name = "safety shutters button"
	},
/turf/open/floor/pod,
/area/shuttle/crow/helm)
"Qy" = (
/turf/closed/wall/mineral/titanium,
/area/shuttle/crow/engineering)
"QL" = (
/obj/effect/decal/cleanable/dirt,
/obj/effect/turf_decal/stripes/line{
	dir = 1
	},
/turf/open/floor/iron,
/area/shuttle/crow/cargo)
"Rh" = (
/turf/closed/wall/mineral/titanium,
/area/shuttle/crow)
"Rs" = (
/obj/structure/cable,
/obj/machinery/door/firedoor,
/obj/machinery/door/airlock/glass,
/obj/effect/mapping_helpers/smart_pipe/manifold4w/scrubbers/hidden/layer2{
	dir = 9
	},
/obj/effect/mapping_helpers/smart_pipe/manifold4w/supply/hidden/layer4{
	dir = 1
	},
/turf/open/floor/pod,
/area/shuttle/crow)
"RX" = (
/obj/structure/sign/poster/random{
	pixel_x = 32
	},
/turf/open/floor/iron,
/area/shuttle/crow/cargo)
"Sy" = (
/obj/effect/turf_decal/bot,
/obj/effect/decal/cleanable/dirt,
/obj/structure/closet/crate,
/obj/effect/mapping_helpers/smart_pipe/manifold4w/orange/hidden,
/turf/open/floor/iron,
/area/shuttle/crow/cargo)
"SC" = (
/obj/structure/cable,
/obj/effect/decal/cleanable/dirt,
/obj/effect/mapping_helpers/smart_pipe/manifold4w/scrubbers/hidden/layer2{
	dir = 9
	},
/obj/effect/mapping_helpers/smart_pipe/manifold4w/supply/hidden/layer4{
	dir = 1
	},
/obj/effect/mapping_helpers/smart_pipe/manifold4w/orange/hidden,
/obj/machinery/meter{
	name = "propellent gas meter"
	},
/turf/open/floor/iron,
/area/shuttle/crow)
"SG" = (
/obj/structure/reagent_dispensers/watertank,
/obj/effect/turf_decal/bot,
/obj/effect/decal/cleanable/dirt,
/obj/item/mop,
/obj/item/reagent_containers/glass/bucket,
/obj/machinery/light/warm/directional/south,
/turf/open/floor/iron,
/area/shuttle/crow/cargo)
"SL" = (
/obj/machinery/atmospherics/components/unary/tank/air{
	dir = 1;
	piping_layer = 4
	},
/obj/effect/decal/cleanable/dirt,
/obj/structure/lattice/catwalk/plated/dark,
/turf/open/floor/plating,
/area/shuttle/crow/engineering)
"Vc" = (
/obj/machinery/door/airlock/external/glass,
/obj/machinery/door/firedoor,
/obj/effect/mapping_helpers/smart_pipe/manifold4w/supply/hidden/layer4{
	dir = 1
	},
/obj/effect/mapping_helpers/smart_pipe/manifold4w/scrubbers/hidden/layer2{
	dir = 9
	},
/obj/structure/lattice/catwalk/plated/dark,
/turf/open/floor/plating,
/area/shuttle/crow)
"VB" = (
/obj/structure/cable,
/obj/effect/mapping_helpers/smart_pipe/manifold4w/scrubbers/hidden/layer2{
	dir = 9
	},
/obj/effect/mapping_helpers/smart_pipe/manifold4w/supply/hidden/layer4{
	dir = 1
	},
/obj/machinery/light/warm/directional/south,
/obj/effect/mapping_helpers/smart_pipe/manifold4w/orange/hidden,
/turf/open/floor/iron,
/area/shuttle/crow)
"Wo" = (
/obj/effect/decal/cleanable/dirt,
/obj/machinery/atmospherics/components/unary/vent_scrubber/on/layer2,
/obj/structure/lattice/catwalk/plated/dark,
/turf/open/floor/plating,
/area/shuttle/crow)
"Ww" = (
/obj/machinery/power/port_gen/pacman{
	anchored = 1
	},
/obj/structure/cable,
/obj/effect/decal/cleanable/dirt,
/obj/item/stack/sheet/mineral/plasma{
	amount = 10
	},
/obj/structure/lattice/catwalk/plated/dark,
/obj/structure/sign/warning/electricshock/small{
	pixel_y = -32
	},
/turf/open/floor/plating,
/area/shuttle/crow/engineering)
"WL" = (
/obj/structure/cable,
/obj/effect/decal/cleanable/dirt,
/obj/structure/chair/comfy/shuttle{
	dir = 4
	},
/obj/machinery/firealarm/directional/west,
/obj/effect/mapping_helpers/smart_pipe/manifold4w/scrubbers/hidden/layer2{
	dir = 9
	},
/obj/effect/mapping_helpers/smart_pipe/manifold4w/supply/hidden/layer4{
	dir = 1
	},
/turf/open/floor/pod,
/area/shuttle/crow)
"WN" = (
/obj/effect/mapping_helpers/smart_pipe/manifold4w/scrubbers/hidden/layer2{
	dir = 9
	},
/turf/open/floor/iron,
/area/shuttle/crow/cargo)
"Zo" = (
/turf/closed/wall/mineral/titanium,
/area/shuttle/crow/cargo)
"ZC" = (
/obj/effect/decal/cleanable/dirt,
/obj/structure/chair/comfy/shuttle{
	dir = 4
	},
/turf/open/floor/pod,
/area/shuttle/crow/helm)

(1,1,1) = {"
Zo
gn
gn
Zo
jL
jL
jL
Zo
gn
gn
Zo
"}
(2,1,1) = {"
Zo
wM
wM
LG
eT
Zo
eT
LG
wM
wM
Zo
"}
(3,1,1) = {"
Zo
lR
dd
Ic
sB
wt
sB
Sy
CR
SG
eT
"}
(4,1,1) = {"
Lp
QL
KJ
fM
fM
qb
gX
iP
RX
jH
eT
"}
(5,1,1) = {"
hk
QL
iP
HK
WN
hB
Zo
Qy
Qy
Qy
Zo
"}
(6,1,1) = {"
Zo
uY
Dy
gD
fM
eb
Zo
bZ
NJ
qM
Qy
"}
(7,1,1) = {"
Zo
Zo
Zo
Zo
Cc
ne
Qy
Dt
DX
cS
Qy
"}
(8,1,1) = {"
Gz
nK
Pc
AU
uQ
VB
Qy
KC
bw
Ww
Qy
"}
(9,1,1) = {"
Eq
OP
Wo
Vc
Fz
SC
oH
zn
AN
kN
Qy
"}
(10,1,1) = {"
Rh
CG
MH
Rh
zS
FP
Qy
iX
fJ
SL
Qy
"}
(11,1,1) = {"
OI
OI
OI
OI
OI
Rs
Rh
Rh
Rh
Rh
Qy
"}
(12,1,1) = {"
OI
hD
og
vj
ec
HV
WL
Bt
Fg
um
Qy
"}
(13,1,1) = {"
dm
PR
ZC
IN
lI
Hu
mR
DO
Hu
fw
jh
"}
(14,1,1) = {"
dm
dm
pL
AB
OI
tN
np
uo
hn
jh
jh
"}
(15,1,1) = {"
jL
dm
dm
OI
OI
Rh
jh
jh
jh
jh
jL
"}
